identity,Bank_A,Bank_B,Bank_C,Bank_D,Total
1000000,55427,69353,57378,27430,209588
1000001,88685,20945,92923,49455,252008
1000002,12642,13403,39075,4728,69848
1000003,56852,69702,12325,75786,214665
1000004,63735,80039,51381,33458,228613
1000005,72083,82217,26307,75339,255946
1000006,93878,68234,60339,23669,246120
1000007,25909,75250,99309,12806,213274
1000008,17981,90757,73270,89561,271569
1000009,28771,93330,82071,58730,262902
1000010,85857,38075,32161,6828,162921
1000011,49403,76679,86966,55233,268281
1000012,59165,41351,59846,64749,225111
1000013,61333,35001,95383,33488,225205
1000014,66537,70799,38572,13544,189452
1000015,11886,19719,88277,21629,141511
1000016,91496,67646,53365,20197,232704
1000017,33548,84147,26235,27306,171236
1000018,52834,81673,8143,10035,152685
1000019,1482,39232,54148,14769,109631
1000020,55538,27770,35524,63439,182271
1000021,59026,67357,91372,47668,265423
1000022,47884,89282,73710,48830,259706
1000023,58182,65050,47795,32441,203468
1000024,89687,51809,85041,68569,295106
1000025,87420,94025,41442,62037,284924
1000026,22085,84684,45990,88040,240799
1000027,33203,46402,22872,56426,158903
1000028,19604,56981,37642,54167,168394
1000029,16265,602,22294,38168,77329
1000030,95524,33519,49269,7586,185898
1000031,60867,41257,89548,86872,278544
1000032,47810,7003,84968,4289,144070
1000033,63084,6372,99412,29784,198652
1000034,71906,14743,22989,61197,170835
1000035,46639,6183,64443,78238,195503
1000036,11276,63096,75233,38929,188534
1000037,36644,3795,59605,59691,159735
1000038,81904,19429,8918,71023,181274
1000039,71403,81455,42922,21717,217497
1000040,42244,81822,19349,48495,191910
1000041,61985,11274,13943,270,87472
1000042,78738,62094,7155,16100,164087
1000043,49560,57939,46512,72679,226690
1000044,12396,13526,39352,22286,87560
1000045,13416,85424,58904,60124,217868
1000046,13491,55638,42603,81793,193525
1000047,1308,43458,79318,44365,168449
1000048,15960,39705,7922,12990,76577
1000049,29777,43090,80395,36081,189343
1000050,18051,43392,78657,82815,222915
1000051,60516,8569,32790,80938,182813
1000052,75027,76662,52642,27780,232111
1000053,17573,13904,72915,52750,157142
1000054,11804,84867,78770,2446,177887
1000055,52554,47324,25442,78204,203524
1000056,77794,84552,32107,51583,246036
1000057,90434,43962,95306,6531,236233
1000058,91353,13693,56750,39181,200977
1000059,37689,41446,8788,50460,138383
1000060,1534,51853,48980,22880,125247
1000061,79098,14866,93455,291,187710
1000062,87947,92590,67548,72111,320196
1000063,94891,31293,46467,43503,216154
1000064,84709,79628,9223,57244,230804
1000065,30899,22664,77268,21856,152687
1000066,69783,9070,12284,66739,157876
1000067,53410,75723,46834,62105,238072
1000068,73825,79786,44780,71978,270369
1000069,66479,58400,22909,33019,180807
1000070,37153,41521,62849,5938,147461
1000071,79393,9159,36329,17058,141939
1000072,32060,74281,53993,89430,249764
1000073,53075,22142,47030,61835,184082
1000074,74989,83786,78028,82125,318928
1000075,52559,99408,24335,23407,199709
1000076,93881,36058,71112,58064,259115
1000077,98984,29382,44214,73421,246001
1000078,25089,95453,55124,94913,270579
1000079,93562,95374,94033,30106,313075
1000080,43942,84917,23625,95333,247817
1000081,99714,59563,69170,52069,280516
1000082,59795,50001,40518,38330,188644
1000083,4970,92168,3970,97139,198247
1000084,38870,35883,44991,89693,209437
1000085,74211,92272,80020,52513,299016
1000086,82926,57112,31403,10854,182295
1000087,97206,77021,69935,40974,285136
1000088,27590,47714,75750,25893,176947
1000089,96879,20899,77078,32414,227270
1000090,25650,57906,60436,95124,239116
1000091,29602,1259,54923,28278,114062
1000092,71477,10163,10431,64246,156317
1000093,14084,274,70833,13198,98389
1000094,62577,61558,70031,14556,208722
1000095,93009,35319,21797,10673,160798
1000096,25020,60019,26253,75197,186489
1000097,39874,48229,57662,16398,162163
1000098,4018,14866,1702,89508,110094
1000099,97291,92762,685,37589,228327
1000100,83071,63106,2246,23035,171458
1000101,47077,61565,8320,71345,188307
1000102,80785,10221,97172,58107,246285
1000103,35826,61172,43265,30944,171207
1000104,4763,92416,36285,98416,231880
1000105,82224,6663,5789,5614,100290
1000106,22244,62160,68964,34097,187465
1000107,41347,36769,89019,35888,203023
1000108,82534,50342,52231,39691,224798
1000109,44124,73281,72677,48877,238959
1000110,78880,74431,43049,7745,204105
1000111,28566,86526,42579,11787,169458
1000112,90968,13130,17290,76689,198077
1000113,37379,28846,35583,67416,169224
1000114,77721,87262,59547,2196,226726
1000115,77558,38326,7212,93210,216306
1000116,24822,47741,97892,4110,174565
1000117,68985,92268,60470,58701,280424
1000118,69105,49810,33245,2370,154530
1000119,59175,65357,80388,52202,257122
1000120,45847,67117,40894,53041,206899
1000121,16857,71442,4385,37929,130613
1000122,39512,4264,11000,78169,132945
1000123,67185,10254,63824,60850,202113
1000124,12606,45799,98570,4569,161544
1000125,11023,53038,24558,85651,174270
1000126,42245,71374,46206,25423,185248
1000127,89356,54770,37325,6139,187590
1000128,8794,50422,32516,84990,176722
1000129,32517,2862,36130,3018,74527
1000130,4248,99095,19838,62491,185672
1000131,699,11898,98681,78057,189335
1000132,23655,14133,44317,73048,155153
1000133,78793,89865,17053,94613,280324
1000134,97694,2990,32173,78712,211569
1000135,50488,29105,56,56683,136332
1000136,8504,65341,78947,68917,221709
1000137,71235,12192,50467,84204,218098
1000138,43465,30175,65029,61156,199825
1000139,16847,76344,37483,15341,146015
1000140,9041,25259,43181,24089,101570
1000141,84401,22523,45151,43482,195557
1000142,57414,36920,61021,7169,162524
1000143,79192,37364,65937,76602,259095
1000144,71963,94496,14816,11866,193141
1000145,41561,65855,17163,84248,208827
1000146,15440,36581,69387,39878,161286
1000147,96319,6680,13681,72947,189627
1000148,29775,88110,227,50993,169105
1000149,92708,62328,24968,63710,243714
1000150,99315,66838,89142,26171,281466
1000151,32656,31948,91766,34989,191359
1000152,35577,27536,72847,92721,228681
1000153,34003,14874,49572,73688,172137
1000154,52505,32193,45980,15870,146548
1000155,51885,60056,4383,91274,207598
1000156,74222,96726,60511,32086,263545
1000157,98556,91425,94251,45006,329238
1000158,20749,53894,98951,88564,262158
1000159,80898,619,82468,2570,166555
1000160,81326,77355,62928,21726,243335
1000161,83614,30231,72701,99152,285698
1000162,64572,42273,38597,15808,161250
1000163,4498,25829,32302,27438,90067
1000164,54915,58972,86518,48241,248646
1000165,55310,7842,52353,34752,150257
1000166,67826,10140,90345,31194,199505
1000167,86380,7242,67462,74183,235267
1000168,25644,29275,99892,9166,163977
1000169,83452,37346,37372,94243,252413
1000170,29868,5134,58309,70869,164180
1000171,67373,20560,26430,43460,157823
1000172,19921,87930,38404,27711,173966
1000173,68820,53996,56977,5704,185497
1000174,70336,30966,82883,10740,194925
1000175,63676,24571,94244,15760,198251
1000176,48057,91161,1180,97297,237695
1000177,93612,46660,34252,93712,268236
1000178,75135,49436,7426,59355,191352
1000179,12535,29325,51190,38329,131379
1000180,74184,9685,48191,73803,205863
1000181,24938,44807,28690,49336,147771
1000182,78658,78885,21966,24030,203539
1000183,10472,96554,11026,43400,161452
1000184,91920,15476,26122,60771,194289
1000185,46421,39730,50134,66200,202485
1000186,87715,29712,17673,84059,219159
1000187,31755,1600,25949,10992,70296
1000188,34076,6996,39730,45494,126296
1000189,72481,75450,84894,85693,318518
1000190,54548,87319,46583,79473,267923
1000191,18522,57649,84679,3332,164182
1000192,34741,29593,58517,70185,193036
1000193,3311,73440,47023,45027,168801
1000194,78817,52604,59607,24407,215435
1000195,75500,28392,59900,75418,239210
1000196,9145,16283,61497,85476,172401
1000197,27055,76914,81061,77921,262951
1000198,69583,17711,82574,33403,203271
1000199,27964,26635,77136,82251,213986
1000200,75323,67856,32272,64306,239757
1000201,64223,75365,25493,18075,183156
1000202,69155,20707,78877,41658,210397
1000203,27104,26179,68063,95397,216743
1000204,40879,31071,42961,85985,200896
1000205,22220,73603,10617,44491,150931
1000206,49555,84469,65727,4677,204428
1000207,54738,37615,80625,52912,225890
1000208,64853,62255,77338,66774,271220
1000209,49432,15466,56417,30792,152107
1000210,20290,56017,52538,25131,153976
1000211,82729,79996,25031,73198,260954
1000212,7912,51736,15498,65008,140154
1000213,20738,4093,92445,58330,175606
1000214,92249,18043,20940,56010,187242
1000215,79608,53928,83270,17467,234273
1000216,80561,14126,23554,57184,175425
1000217,92673,65250,49006,90915,297844
1000218,83289,63222,77408,87738,311657
1000219,94396,74144,64832,19265,252637
1000220,91897,94233,5375,29579,221084
1000221,87731,5799,85360,23385,202275
1000222,37187,35670,14415,18870,106142
1000223,98575,52866,63802,30377,245620
1000224,69134,98855,92466,33718,294173
1000225,17629,65678,60323,44280,187910
1000226,90221,11456,2305,93098,197080
1000227,62677,50871,4676,23534,141758
1000228,77955,52647,87710,76625,294937
1000229,13854,57218,10936,36060,118068
1000230,86340,34554,8468,25226,154588
1000231,48545,29492,66213,65492,209742
1000232,77509,47891,10229,51445,187074
1000233,89686,48034,6141,29888,173749
1000234,29773,92189,70849,57423,250234
1000235,2834,76093,91499,59024,229450
1000236,86892,99360,23419,43363,253034
1000237,92209,57813,84030,74000,308052
1000238,80349,39159,62264,44768,226540
1000239,79966,8807,32423,76985,198181
1000240,92425,67021,74811,65315,299572
1000241,26379,26170,99216,287,152052
1000242,78290,35030,16570,75695,205585
1000243,14880,78594,10078,43921,147473
1000244,23006,51707,24265,18375,117353
1000245,74537,47010,35475,44205,201227
1000246,35179,80488,86018,56687,258372
1000247,98217,45028,54120,51914,249279
1000248,18067,17366,79025,68132,182590
1000249,10437,18118,99482,25289,153326
1000250,75128,17161,59873,53339,205501
1000251,84954,16218,93445,6399,201016
1000252,26429,29808,62330,89789,208356
1000253,42497,54289,70504,27048,194338
1000254,35930,33209,44163,94865,208167
1000255,18774,22885,59086,89696,190441
1000256,82167,52997,48445,13674,197283
1000257,10809,22419,82191,93635,209054
1000258,16171,92854,22072,95615,226712
1000259,5982,91975,23155,39439,160551
1000260,56492,30444,47450,44619,179005
1000261,35752,86205,27911,20052,169920
1000262,1737,24055,31712,51842,109346
1000263,48335,1483,20013,62684,132515
1000264,7917,97096,73691,69713,248417
1000265,86212,97294,96876,41560,321942
1000266,32837,31082,23320,56013,143252
1000267,71943,92229,67884,87735,319791
1000268,6666,15370,23525,88286,133847
1000269,39139,51056,44015,37578,171788
1000270,99042,35715,63234,3967,201958
1000271,16374,24662,66875,53220,161131
1000272,72996,70951,88048,42449,274444
1000273,12378,87104,75693,83037,258212
1000274,57285,58859,56288,37433,209865
1000275,62205,80665,36673,81026,260569
1000276,39261,40294,84194,48385,212134
1000277,78172,47007,39853,49751,214783
1000278,12659,22922,21764,66653,123998
1000279,72773,88480,83194,10407,254854
1000280,81697,97380,88910,50816,318803
1000281,79,34097,70748,89298,194222
1000282,16010,7339,67910,12967,104226
1000283,24331,58726,590,77784,161431
1000284,46908,30855,98343,53363,229469
1000285,23465,20263,93306,74735,211769
1000286,44224,69336,4031,92318,209909
1000287,31135,93767,45159,10960,181021
1000288,9726,21152,58195,73340,162413
1000289,19743,6023,11798,4799,42363
1000290,13469,81773,72843,98907,266992
1000291,80843,22284,94844,46163,244134
1000292,74263,89255,25355,47593,236466
1000293,84537,74872,95222,13476,268107
1000294,46962,75224,59001,70862,252049
1000295,69614,67448,77013,21508,235583
1000296,58413,99551,11039,21135,190138
1000297,64397,56561,11781,92795,225534
1000298,59760,39868,31091,22329,153048
1000299,35873,51109,29239,80735,196956
1000300,59050,56279,21149,62287,198765
1000301,28834,4299,35105,78855,147093
1000302,35742,17883,44699,98860,197184
1000303,35043,50611,736,43394,129784
1000304,38959,50215,22995,46924,159093
1000305,57594,26936,21180,74357,180067
1000306,76784,42270,50039,580,169673
1000307,12418,12300,50221,43903,118842
1000308,46156,23104,90151,53643,213054
1000309,49992,54590,94757,96795,296134
1000310,528,11613,98748,44627,155516
1000311,20078,69462,39075,90672,219287
1000312,84179,64555,72172,61834,282740
1000313,19492,17085,44944,5160,86681
1000314,84218,58028,79502,60261,282009
1000315,66194,59983,95429,13566,235172
1000316,16840,93754,66564,13097,190255
1000317,53658,11029,69581,12767,147035
1000318,79409,79684,4531,26471,190095
1000319,70025,98788,59560,89909,318282
1000320,10376,38079,65533,33709,147697
1000321,63521,95792,55173,70647,285133
1000322,9383,26338,28732,97906,162359
1000323,23703,56674,3042,2995,86414
1000324,41350,51886,17903,80693,191832
1000325,50635,62816,52491,15622,181564
1000326,35763,15868,53595,86375,191601
1000327,49383,16544,97222,65030,228179
1000328,71553,27623,61008,20495,180679
1000329,57276,22314,51698,36794,168082
1000330,49767,85029,25336,52423,212555
1000331,12039,23264,50708,88621,174632
1000332,96351,91054,2443,69106,258954
1000333,26043,10221,37981,12567,86812
1000334,49059,40835,19845,25515,135254
1000335,9903,63475,31082,83910,188370
1000336,84925,50509,41232,67045,243711
1000337,41755,13328,89144,95671,239898
1000338,10601,53647,30585,21627,116460
1000339,85590,19732,69787,82210,257319
1000340,19116,4080,67822,9937,100955
1000341,91290,67095,38879,23195,220459
1000342,83506,76846,12416,86475,259243
1000343,78974,51705,16605,97870,245154
1000344,62877,34002,51564,69997,218440
1000345,53179,6599,99111,29729,188618
1000346,38256,99737,88269,52826,279088
1000347,78507,20724,65516,81330,246077
1000348,25259,90054,95609,2395,213317
1000349,36727,31890,41782,98101,208500
1000350,22370,90235,32995,67128,212728
1000351,64116,4212,34392,84514,187234
1000352,34712,47142,19803,46036,147693
1000353,21423,23965,76281,50462,172131
1000354,92440,56579,42108,6254,197381
1000355,58424,4391,69047,99459,231321
1000356,94441,70214,71363,35811,271829
1000357,61708,11803,87381,10519,171411
1000358,99022,76204,69653,30572,275451
1000359,12061,27036,33141,9203,81441
1000360,10467,80877,1382,61987,154713
1000361,90316,94801,86667,88290,360074
1000362,2741,64177,66893,86543,220354
1000363,85381,36187,17081,18890,157539
1000364,35574,53107,87536,79855,256072
1000365,51287,54875,95992,55908,258062
1000366,79974,68731,88782,36198,273685
1000367,39043,59113,58408,18775,175339
1000368,28009,890,30792,4810,64501
1000369,37524,23146,65547,30959,157176
1000370,2436,55119,20716,65592,143863
1000371,14271,98464,64977,33583,211295
1000372,77288,79238,38846,8786,204158
1000373,2495,67425,33754,41304,144978
1000374,86999,87546,52452,38196,265193
1000375,19389,11753,24606,61923,117671
1000376,70284,34003,52954,32524,189765
1000377,73881,16439,86294,11548,188162
1000378,94299,25342,8051,80205,207897
1000379,66571,86746,99376,77381,330074
1000380,64102,12384,44652,6817,127955
1000381,57735,37457,58116,13668,166976
1000382,61412,14476,70811,78602,225301
1000383,5302,38621,64143,9793,117859
1000384,32633,85437,19767,67921,205758
1000385,63559,38237,45491,44871,192158
1000386,35412,57638,3143,30642,126835
1000387,68485,44861,18145,778,132269
1000388,5270,60222,21377,7072,93941
1000389,5716,63363,810,50239,120128
1000390,67487,73153,88290,40127,269057
1000391,65904,11735,50301,78825,206765
1000392,57052,13130,80816,93078,244076
1000393,28843,34781,3871,13628,81123
1000394,14615,70773,57636,43377,186401
1000395,69889,65803,7566,70230,213488
1000396,56338,50420,65716,96495,268969
1000397,93583,94497,22031,28985,239096
1000398,72214,23749,55814,66227,218004
1000399,5486,72016,42471,87886,207859
1000400,20812,76026,83104,48500,228442
1000401,10098,9517,6679,67698,93992
1000402,85042,55552,60484,18589,219667
1000403,10077,24777,69895,66555,171304
1000404,95566,72165,29271,60760,257762
1000405,93046,11273,19748,32320,156387
1000406,78844,5614,71795,85136,241389
1000407,96083,29911,4780,85110,215884
1000408,55132,68506,44459,40559,208656
1000409,77538,86673,74461,84772,323444
1000410,83814,41083,75686,88380,288963
1000411,47493,19980,71262,29717,168452
1000412,80423,972,98640,21807,201842
1000413,80643,51707,79778,40505,252633
1000414,37942,10444,51947,66437,166770
1000415,44983,60038,37597,43663,186281
1000416,58037,38327,99666,20692,216722
1000417,62454,35230,28576,68465,194725
1000418,2854,50980,9174,81169,144177
1000419,94540,53072,28673,21511,197796
1000420,32876,21372,71032,56102,181382
1000421,68845,88270,67634,17643,242392
1000422,41173,67042,26495,88325,223035
1000423,85087,57518,61899,45657,250161
1000424,18259,49394,20681,93832,182166
1000425,48822,9081,95923,6930,160756
1000426,27068,59055,16448,99831,202402
1000427,28334,6925,94386,3814,133459
1000428,20879,67367,85164,97374,270784
1000429,90223,4985,94997,17230,207435
1000430,22873,43118,86225,87396,239612
1000431,76394,272,53229,65141,195036
1000432,65959,9746,39700,31808,147213
1000433,73158,57181,47670,31317,209326
1000434,42135,84840,75846,97298,300119
1000435,26037,59971,15607,12148,113763
1000436,60262,4718,96124,66181,227285
1000437,47639,9689,29666,30547,117541
1000438,7387,30777,93036,89929,221129
1000439,67654,93013,9121,4404,174192
1000440,91797,1881,78813,48422,220913
1000441,81484,5129,80116,3181,169910
1000442,80580,34428,48040,97567,260615
1000443,27705,54360,88868,47679,218612
1000444,86452,3950,20660,49076,160138
1000445,64272,44142,93066,62955,264435
1000446,51454,92561,41063,65671,250749
1000447,13445,35317,39085,74972,162819
1000448,23430,25474,43911,65501,158316
1000449,30473,47600,97962,13460,189495
1000450,83278,95253,49056,90800,318387
1000451,46254,7371,70178,47398,171201
1000452,81770,10202,344,66658,158974
1000453,73983,1518,77671,11766,164938
1000454,62899,36066,76442,17018,192425
1000455,41235,48911,10672,24025,124843
1000456,57589,94235,45219,14694,211737
1000457,63017,47716,22251,59394,192378
1000458,86728,52679,24249,54715,218371
1000459,50553,6863,88708,47819,193943
1000460,1438,31870,26618,83187,143113
1000461,63500,61709,20610,66606,212425
1000462,30872,49488,78465,71256,230081
1000463,50316,52921,58067,25936,187240
1000464,48798,28892,38185,13811,129686
1000465,58758,78105,67258,18817,222938
1000466,55637,44793,38412,4354,143196
1000467,12944,8333,5942,80469,107688
1000468,54513,90856,49137,41764,236270
1000469,88843,78755,76028,28025,271651
1000470,16816,26083,22369,75811,141079
1000471,83041,7664,11847,19332,121884
1000472,75836,84689,99144,79478,339147
1000473,54027,24192,97109,33712,209040
1000474,21939,89524,86856,9796,208115
1000475,21519,47243,16743,30535,116040
1000476,32475,1127,28153,78268,140023
1000477,53049,29586,72142,36074,190851
1000478,75252,62896,66894,77724,282766
1000479,11221,79753,75442,63621,230037
1000480,97916,82429,99924,31432,311701
1000481,68206,71151,59520,39303,238180
1000482,91216,35823,87701,82556,297296
1000483,81509,87560,85602,69905,324576
1000484,73678,78428,97006,96156,345268
1000485,37243,68129,8036,8516,121924
1000486,36154,12632,44674,7042,100502
1000487,38493,12610,62521,49996,163620
1000488,17500,86407,77264,60109,241280
1000489,48304,43184,78561,58708,228757
1000490,15529,82605,51191,95875,245200
1000491,7822,88943,28135,22454,147354
1000492,79501,7766,37465,67476,192208
1000493,92593,28414,13842,73150,207999
1000494,68210,80223,51071,45057,244561
1000495,43629,31558,35069,65347,175603
1000496,15178,12110,18745,45143,91176
1000497,96874,19949,93864,46720,257407
1000498,61378,466,34512,68752,165108
1000499,72492,19332,88995,71941,252760
1000500,80469,3773,42133,49532,175907
1000501,38227,99962,91710,26789,256688
1000502,74470,27896,82549,54675,239590
1000503,16031,64915,72051,44449,197446
1000504,82255,23595,17694,89581,213125
1000505,56984,85109,98878,91397,332368
1000506,52149,53326,20145,57534,183154
1000507,68503,38395,10359,97831,215088
1000508,27442,1401,71529,66305,166677
1000509,55517,65423,63956,50805,235701
1000510,48735,47580,25574,2923,124812
1000511,19233,5491,63188,98097,186009
1000512,57623,46347,35404,80129,219503
1000513,7582,46214,54281,49221,157298
1000514,90673,23269,54068,70049,238059
1000515,27837,94545,53963,58211,234556
1000516,54120,32124,57414,27963,171621
1000517,21195,26175,71770,55622,174762
1000518,52388,82373,59821,23459,218041
1000519,61522,21635,53825,17520,154502
1000520,36383,52675,75790,93787,258635
1000521,14181,35560,76178,25641,151560
1000522,57250,96338,22135,88721,264444
1000523,28679,21872,38297,44300,133148
1000524,22795,16525,50877,99240,189437
1000525,76048,76697,22906,77106,252757
1000526,30256,68205,63655,10954,173070
1000527,12411,36292,97022,76012,221737
1000528,30946,22534,33037,79973,166490
1000529,46197,30771,27425,69569,173962
1000530,22615,37683,16374,96451,173123
1000531,44266,36316,21696,35644,137922
1000532,96863,39274,52723,33004,221864
1000533,95373,1503,20371,10930,128177
1000534,80543,32094,65640,72745,251022
1000535,51908,54496,72620,63072,242096
1000536,84836,41236,26667,77990,230729
1000537,39276,94517,26028,54215,214036
1000538,9077,49063,499,87900,146539
1000539,10274,36979,36383,49032,132668
1000540,42779,34712,48419,11056,136966
1000541,39626,67727,31585,18645,157583
1000542,28733,34200,27263,39143,129339
1000543,7677,83016,29397,74489,194579
1000544,68061,37807,23549,77120,206537
1000545,13679,6074,78347,73592,171692
1000546,43070,50008,80512,49318,222908
1000547,77824,32908,34358,40755,185845
1000548,61426,6709,5608,77097,150840
1000549,35150,58308,49454,6260,149172
1000550,90067,30655,24626,84721,230069
1000551,31735,84557,55115,52214,223621
1000552,25507,98657,11982,49629,185775
1000553,10161,78995,79968,84641,253765
1000554,67734,23392,89188,96757,277071
1000555,5075,15789,84238,79465,184567
1000556,23478,98360,99264,21546,242648
1000557,13525,77148,80869,66614,238156
1000558,33676,8386,20141,90745,152948
1000559,23475,29683,74839,12382,140379
1000560,49358,11528,82440,38496,181822
1000561,9112,81706,72820,3647,167285
1000562,97995,56574,52367,53401,260337
1000563,61887,20679,93447,81991,258004
1000564,21736,82248,40709,51157,195850
1000565,53224,88585,37896,39253,218958
1000566,87224,49065,28711,52047,217047
1000567,17602,67203,67428,46910,199143
1000568,23596,82706,49650,82863,238815
1000569,48499,49249,65106,11904,174758
1000570,49246,26896,78098,73179,227419
1000571,57446,3417,37423,6989,105275
1000572,61209,4134,62150,67157,194650
1000573,72485,38620,29734,60339,201178
1000574,96218,12188,93045,29457,230908
1000575,12279,27158,62512,69985,171934
1000576,5775,1753,37793,55213,100534
1000577,74240,35815,95679,32851,238585
1000578,36956,41226,54534,68657,201373
1000579,67895,42887,85724,75180,271686
1000580,61345,67089,56328,53763,238525
1000581,8953,59085,83060,83773,234871
1000582,26830,85646,97089,26332,235897
1000583,81118,74756,30811,52484,239169
1000584,12020,3847,8973,60006,84846
1000585,45496,79404,32488,67382,224770
1000586,14533,45168,57811,61029,178541
1000587,21592,2833,50900,16269,91594
1000588,77212,44929,21123,88010,231274
1000589,58857,112,24513,71028,154510
1000590,61734,87514,57274,76022,282544
1000591,15384,61427,4021,48760,129592
1000592,97132,46566,70212,69748,283658
1000593,72757,30950,75226,88429,267362
1000594,50157,88114,13833,73727,225831
1000595,96266,9534,89634,9918,205352
1000596,74261,22144,93337,60820,250562
1000597,61921,38938,46356,37756,184971
1000598,48356,82073,42929,29391,202749
1000599,35492,38892,58700,51554,184638
1000600,46632,16986,80533,1241,145392
1000601,44053,9011,52177,53401,158642
1000602,57265,48015,44881,75837,225998
1000603,81421,65991,48162,29705,225279
1000604,72506,16499,29608,86581,205194
1000605,38682,49413,13992,85583,187670
1000606,24667,73710,47587,58775,204739
1000607,35415,59542,92067,85339,272363
1000608,21187,86325,20460,10394,138366
1000609,7738,54533,14290,49156,125717
1000610,99640,51581,48588,83143,282952
1000611,80557,20998,35093,71291,207939
1000612,68687,10284,60296,81176,220443
1000613,19299,7657,16708,86124,129788
1000614,78238,2940,34367,79585,195130
1000615,58830,68267,59852,44095,231044
1000616,48679,5673,1960,86457,142769
1000617,22261,59528,84525,96798,263112
1000618,82340,82154,55956,72021,292471
1000619,30677,48715,47008,84660,211060
1000620,12837,83715,30356,61700,188608
1000621,20705,48445,30298,47679,147127
1000622,7358,97317,39449,36227,180351
1000623,86828,60078,77531,11421,235858
1000624,46284,99415,70567,2902,219168
1000625,77849,13116,72500,29255,192720
1000626,86348,21273,15466,9845,132932
1000627,26625,72734,46427,1100,146886
1000628,27619,39896,22642,52303,142460
1000629,82216,26620,67928,81302,258066
1000630,31840,42906,93647,99970,268363
1000631,61480,66379,68864,18593,215316
1000632,16807,43497,70099,56419,186822
1000633,93118,57534,22685,3652,176989
1000634,72789,18689,10700,65345,167523
1000635,16518,9518,13719,27831,67586
1000636,7057,17641,98403,61549,184650
1000637,65065,19960,74599,55678,215302
1000638,29430,25049,45922,97985,198386
1000639,32507,71071,76145,65418,245141
1000640,44686,87527,38830,96140,267183
1000641,58098,84848,24220,88058,255224
1000642,66435,13012,18356,2335,100138
1000643,371,43707,67800,51851,163729
1000644,60319,14421,37312,89458,201510
1000645,70049,19656,43288,53367,186360
1000646,56418,50160,99514,99573,305665
1000647,64652,99769,7397,96251,268069
1000648,27369,47145,52239,49279,176032
1000649,41115,64845,67533,40132,213625
1000650,80677,97696,47238,82178,307789
1000651,42698,4887,94843,78904,221332
1000652,60888,77247,51691,24571,214397
1000653,29338,84575,11488,5165,130566
1000654,84666,97639,37879,93573,313757
1000655,15697,17457,42640,36668,112462
1000656,34080,18232,35872,65423,153607
1000657,63783,72565,35734,48357,220439
1000658,28799,58584,68474,9125,164982
1000659,2902,10531,86704,29893,130030
1000660,53366,22675,145,33355,109541
1000661,1215,27582,34539,41279,104615
1000662,35910,92747,26797,61757,217211
1000663,47922,25793,26324,27998,128037
1000664,71323,13171,30212,5996,120702
1000665,63255,11501,37977,28469,141202
1000666,56605,52503,88634,70052,267794
1000667,90776,61250,36686,8336,197048
1000668,19786,44483,39833,18973,123075
1000669,91770,76948,36359,11997,217074
1000670,36562,47713,78784,88751,251810
1000671,67552,49632,87395,50867,255446
1000672,41443,94564,73152,73297,282456
1000673,45682,35165,51980,96406,229233
1000674,13929,67976,48352,63223,193480
1000675,78390,10356,35969,15867,140582
1000676,65095,72579,97920,72593,308187
1000677,9577,73177,83898,12146,178798
1000678,23155,5622,91183,3346,123306
1000679,16980,77935,41630,11054,147599
1000680,98997,59582,68719,22407,249705
1000681,89385,70922,61946,54860,277113
1000682,97603,20087,96285,56386,270361
1000683,22905,47811,50126,40930,161772
1000684,78452,30805,95926,19442,224625
1000685,96283,12455,12800,71576,193114
1000686,90902,48015,43765,87586,270268
1000687,29644,39578,52712,38635,160569
1000688,68450,64863,99926,14531,247770
1000689,85335,23459,14337,46498,169629
1000690,24958,74870,21447,57241,178516
1000691,46462,51310,58621,66366,222759
1000692,65299,55769,54578,53063,228709
1000693,1764,21477,41453,63966,128660
1000694,83008,79493,35113,13797,211411
1000695,95343,48314,62158,80519,286334
1000696,40108,97016,95051,27266,259441
1000697,86868,14768,26842,11530,140008
1000698,71365,75060,69777,68200,284402
1000699,55840,79175,97292,85523,317830
1000700,34996,22212,35844,28693,121745
1000701,93176,96190,1747,19602,210715
1000702,86354,99536,73401,73692,332983
1000703,21711,13321,13925,41844,90801
1000704,76163,91493,7559,95067,270282
1000705,66229,3271,47592,27414,144506
1000706,71576,80752,33268,66808,252404
1000707,8811,56966,28675,98231,192683
1000708,77969,12384,19892,21631,131876
1000709,57406,1757,36257,68281,163701
1000710,52130,68940,51297,91634,264001
1000711,41987,44951,8077,49494,144509
1000712,13451,50303,77864,12843,154461
1000713,84760,25325,17561,56758,184404
1000714,26325,52990,1494,84828,165637
1000715,23687,86035,86582,71612,267916
1000716,49409,41560,91472,23995,206436
1000717,28023,45224,68283,83415,224945
1000718,82712,38327,61226,90545,272810
1000719,5649,94139,82491,71134,253413
1000720,36537,95667,52370,15222,199796
1000721,53269,90788,34333,94477,272867
1000722,33818,81775,54109,71355,241057
1000723,47596,6987,50103,46028,150714
1000724,8368,41210,53422,39955,142955
1000725,40341,24097,12644,2832,79914
1000726,66360,96057,92300,74574,329291
1000727,70175,98395,92620,99085,360275
1000728,13529,58990,867,17780,91166
1000729,625,53378,39881,80446,174330
1000730,63808,56873,24633,95113,240427
1000731,1287,3743,12675,53257,70962
1000732,31008,64628,64467,93427,253530
1000733,86246,98167,24475,37727,246615
1000734,92679,86470,75883,66414,321446
1000735,43358,36997,77202,71538,229095
1000736,77459,48157,45007,74316,244939
1000737,13957,7792,90857,71451,184057
1000738,40476,84485,3107,28690,156758
1000739,54301,22738,50454,29356,156849
1000740,93412,23122,37081,93605,247220
1000741,23966,80433,52075,33874,190348
1000742,70090,76683,32289,46096,225158
1000743,44699,65124,92489,55936,258248
1000744,86192,63298,77706,32991,260187
1000745,41086,85716,1088,87264,215154
1000746,43677,55370,51498,9323,159868
1000747,60734,31123,33764,26128,151749
1000748,86519,43694,28702,35535,194450
1000749,18522,32793,6049,26313,83677
1000750,48289,59448,64861,54104,226702
1000751,29106,98621,79343,33152,240222
1000752,83046,78185,95991,78726,335948
1000753,98209,22511,36613,59916,217249
1000754,46367,26069,7231,92825,172492
1000755,92381,82726,83872,49577,308556
1000756,29164,14002,93130,68460,204756
1000757,59898,97026,64226,81417,302567
1000758,94257,91561,60357,84463,330638
1000759,35156,19032,82606,91004,227798
1000760,42507,38273,21769,70363,172912
1000761,23479,44111,25934,88964,182488
1000762,4048,53941,69369,46978,174336
1000763,63624,60907,39244,39480,203255
1000764,96844,27546,24163,77153,225706
1000765,56382,1504,90696,57721,206303
1000766,78527,14777,62750,50449,206503
1000767,47071,74525,36779,42871,201246
1000768,56461,3495,76550,40300,176806
1000769,57377,9212,99901,30072,196562
1000770,89789,28007,4173,83334,205303
1000771,25583,77340,83073,32301,218297
1000772,58943,3825,90441,69398,222607
1000773,15742,33806,74528,60738,184814
1000774,90835,40175,20608,53185,204803
1000775,37895,20468,94101,233,152697
1000776,76134,28345,32270,92904,229653
1000777,99380,79804,94605,91641,365430
1000778,68117,12923,46386,73802,201228
1000779,87797,53160,67347,52559,260863
1000780,13598,50772,58489,1290,124149
1000781,13498,40188,50890,83607,188183
1000782,92920,44470,14468,17593,169451
1000783,58481,91710,58615,17772,226578
1000784,41352,26159,80680,26596,174787
1000785,28909,13099,32185,76288,150481
1000786,20340,34666,21474,63956,140436
1000787,12107,68510,97679,78670,256966
1000788,51461,69471,33262,26541,180735
1000789,20337,5223,92233,35959,153752
1000790,29393,91674,79380,55619,256066
1000791,87931,18113,79492,29647,215183
1000792,63767,22828,15990,40642,143227
1000793,16251,99598,19528,77212,212589
1000794,33190,84360,76346,63425,257321
1000795,50902,95090,65668,53449,265109
1000796,24980,44055,3341,97989,170365
1000797,72823,75157,21098,24330,193408
1000798,65977,30789,43756,69676,210198
1000799,63735,5629,76525,45584,191473
1000800,67985,51527,80414,68245,268171
1000801,63886,71043,58199,47457,240585
1000802,5816,71881,4087,74929,156713
1000803,9301,49524,45687,60405,164917
1000804,74877,57755,36054,63337,232023
1000805,99985,61854,56140,57085,275064
1000806,64376,2944,54802,58185,180307
1000807,30665,68443,33665,72212,204985
1000808,63649,59008,31488,60968,215113
1000809,21859,4312,58465,61489,146125
1000810,91793,56659,92475,88623,329550
1000811,56436,37573,69042,12946,175997
1000812,89906,8791,63432,72669,234798
1000813,56203,44424,62952,8199,171778
1000814,60376,74105,44537,82472,261490
1000815,16946,3968,10430,9387,40731
1000816,90602,45465,63059,74092,273218
1000817,34455,61090,12271,34466,142282
1000818,61782,86151,51962,13946,213841
1000819,1135,62926,28830,53117,146008
1000820,62509,1706,894,27224,92333
1000821,98777,93596,52782,72361,317516
1000822,46879,53379,9791,31350,141399
1000823,20564,32404,38021,7956,98945
1000824,78797,100000,88166,57184,324147
1000825,61507,23246,17630,49646,152029
1000826,9147,19511,51267,60575,140500
1000827,1875,40414,15522,77684,135495
1000828,41472,76520,26209,50185,194386
1000829,12413,39227,58624,89440,199704
1000830,26736,88471,41277,34247,190731
1000831,56839,13390,3602,57065,130896
1000832,50124,41822,45205,23218,160369
1000833,78364,85207,9546,13438,186555
1000834,29356,86512,86582,67798,270248
1000835,9301,80683,38869,10843,139696
1000836,50106,66300,40801,21607,178814
1000837,96086,90975,45720,96134,328915
1000838,63406,55676,82407,35691,237180
1000839,66741,70834,78631,10171,226377
1000840,39295,50172,91594,47347,228408
1000841,51667,54746,25616,9343,141372
1000842,73097,91187,76382,56151,296817
1000843,54787,53061,53312,64130,225290
1000844,6972,50606,47989,80175,185742
1000845,38795,52533,47830,60588,199746
1000846,83656,87137,51554,50816,273163
1000847,24655,55652,64940,23227,168474
1000848,30952,64209,39138,72283,206582
1000849,37794,60225,12508,31451,141978
1000850,67994,19392,60922,24043,172351
1000851,29787,47812,18716,74665,170980
1000852,45063,43545,79545,48119,216272
1000853,25007,3980,68308,23616,120911
1000854,48756,5944,79543,80781,215024
1000855,3882,97908,40996,4,142790
1000856,31329,61603,87328,44776,225036
1000857,14804,60385,62649,48178,186016
1000858,3119,13914,14578,58783,90394
1000859,70501,80538,48154,60671,259864
1000860,89834,46773,88022,78159,302788
1000861,93042,10675,43124,58511,205352
1000862,91019,37289,79547,61892,269747
1000863,39623,80187,18964,59769,198543
1000864,56723,44906,73124,11089,185842
1000865,1926,53128,56688,52213,163955
1000866,5895,99763,36976,81990,224624
1000867,69435,73502,47533,14743,205213
1000868,39203,73619,87169,99267,299258
1000869,425,57774,59607,86421,204227
1000870,78808,41029,76252,89036,285125
1000871,93185,4993,59042,68539,225759
1000872,10985,26998,34684,11818,84485
1000873,29765,42874,53950,23206,149795
1000874,52370,7669,79083,90811,229933
1000875,33591,48938,50638,75424,208591
1000876,22922,2848,63627,18744,108141
1000877,60517,62116,47861,99494,269988
1000878,6790,90426,98587,12438,208241
1000879,84007,71959,73587,72683,302236
1000880,34543,40856,40501,36898,152798
1000881,55426,1588,25780,93760,176554
1000882,89753,6326,43086,64078,203243
1000883,94928,74278,87193,8410,264809
1000884,85446,49327,40521,12224,187518
1000885,132,64394,17703,51238,133467
1000886,584,70962,38248,30744,140538
1000887,80322,19105,99197,44173,242797
1000888,10818,48455,40983,11639,111895
1000889,31818,61086,55396,48134,196434
1000890,47052,35787,30761,79283,192883
1000891,81775,36436,16669,59068,193948
1000892,4935,40519,31001,85195,161650
1000893,95492,67559,28003,19558,210612
1000894,53916,98158,30505,84947,267526
1000895,88453,1285,12910,33690,136338
1000896,4904,9302,57752,14305,86263
1000897,40267,61529,85733,82873,270402
1000898,68106,19625,72183,9502,169416
1000899,87521,7399,92745,63856,251521
1000900,12419,54291,20494,46754,133958
1000901,85999,47286,36512,17326,187123
1000902,24578,22835,81142,89215,217770
1000903,37856,40937,97362,14211,190366
1000904,17088,71088,97547,43369,229092
1000905,83696,81041,67987,56118,288842
1000906,67769,58942,49599,77849,254159
1000907,73742,28848,5074,36442,144106
1000908,67635,79033,58788,62521,267977
1000909,95850,40368,64128,96,200442
1000910,6975,20461,24540,18610,70586
1000911,46721,14465,68750,98783,228719
1000912,78679,58376,49469,50914,237438
1000913,78515,22822,48651,41074,191062
1000914,94392,93575,8453,9919,206339
1000915,61321,29361,37925,75700,204307
1000916,65305,72741,65086,70768,273900
1000917,40496,45789,76834,57669,220788
1000918,79270,41271,24436,10766,155743
1000919,36575,12625,94079,38048,181327
1000920,10294,51913,38225,69220,169652
1000921,99593,98383,13734,59819,271529
1000922,70529,80011,27282,78065,255887
1000923,68117,87493,98130,44465,298205
1000924,23204,77834,20009,20225,141272
1000925,40128,65277,84674,98857,288936
1000926,52430,31133,16402,59804,159769
1000927,11080,98448,20894,64612,195034
1000928,56486,9544,92751,4280,163061
1000929,89485,98207,1779,95193,284664
1000930,54019,52430,78315,12530,197294
1000931,47658,3877,11907,30474,93916
1000932,78850,50918,64241,36124,230133
1000933,28065,11737,58988,67629,166419
1000934,29415,63989,77050,30398,200852
1000935,29224,53311,48272,65527,196334
1000936,20722,1599,84759,51736,158816
1000937,1701,88632,98087,15509,203929
1000938,53522,74107,20813,25836,174278
1000939,7531,61006,31422,69137,169096
1000940,257,30539,85200,23404,139400
1000941,59429,81237,30851,42686,214203
1000942,48914,455,58862,91183,199414
1000943,429,84192,9337,26754,120712
1000944,36950,37599,54363,68696,197608
1000945,67541,75279,32647,94693,270160
1000946,84133,48752,25639,1325,159849
1000947,42151,29473,70360,49696,191680
1000948,79170,77457,67096,41361,265084
1000949,83705,87308,40856,83023,294892
1000950,21411,35109,35781,60416,152717
1000951,47444,6995,47269,67182,168890
1000952,50630,14096,73151,62315,200192
1000953,73250,47036,79273,6361,205920
1000954,98710,45729,14482,27096,186017
1000955,98171,12797,64156,96928,272052
1000956,14632,27212,4937,44036,90817
1000957,34399,19446,78885,44025,176755
1000958,91565,12854,82501,42407,229327
1000959,73724,89378,43184,52270,258556
1000960,21207,63364,4847,60017,149435
1000961,14065,57756,58882,522,131225
1000962,81779,7694,76861,27720,194054
1000963,73345,27562,77724,70074,248705
1000964,34838,7688,55037,89631,187194
1000965,7027,71416,37868,65109,181420
1000966,14994,76568,82352,93964,267878
1000967,69556,6801,93730,1208,171295
1000968,47334,10183,66490,3443,127450
1000969,24774,10012,90480,26873,152139
1000970,27506,90010,34200,42066,193782
1000971,60710,62358,38954,1071,163093
1000972,69931,63605,82406,33442,249384
1000973,10185,13343,47267,12120,82915
1000974,75093,5125,55850,46791,182859
1000975,73023,65331,57828,1493,197675
1000976,19466,970,43657,30127,94220
1000977,96183,58773,74408,91830,321194
1000978,61322,23056,54221,55917,194516
1000979,50721,80424,40322,95061,266528
1000980,845,51494,77899,11334,141572
1000981,84831,38158,90806,59524,273319
1000982,58992,67320,75168,77151,278631
1000983,8651,75080,47066,82731,213528
1000984,29322,23069,27467,14694,94552
1000985,7241,35208,23503,64652,130604
1000986,42637,16010,6570,26859,92076
1000987,7015,14222,75943,63035,160215
1000988,53976,38158,16320,63995,172449
1000989,23893,4282,98823,58636,185634
1000990,62926,78628,96396,36572,274522
1000991,12543,57375,43790,25871,139579
1000992,56058,35362,61528,15349,168297
1000993,26334,4644,21308,22490,74776
1000994,61227,84529,54918,77846,278520
1000995,16207,51534,3992,96015,167748
1000996,60792,50910,20233,58440,190375
1000997,82741,98043,90657,63475,334916
1000998,90344,79555,41229,10562,221690
1000999,88613,813,46797,30366,166589
1001000,48185,78964,13118,79969,220236
1001001,99348,891,22156,65464,187859
1001002,42089,18305,66780,96382,223556
1001003,50694,3628,92062,35377,181761
1001004,37472,8278,75337,86963,208050
1001005,60558,15060,23602,17434,116654
1001006,6902,94298,95636,9134,205970
1001007,82582,12968,78427,28728,202705
1001008,17948,82437,74225,14301,188911
1001009,46011,67115,67215,12535,192876
1001010,5063,66069,48794,58800,178726
1001011,50976,6,83270,45076,179328
1001012,17707,19679,10652,38905,86943
1001013,3261,72720,19289,69502,164772
1001014,28572,59926,84287,72280,245065
1001015,51604,40662,49840,61889,203995
1001016,76636,93728,35021,42229,247614
1001017,93699,71635,46757,79783,291874
1001018,80581,3744,38583,76366,199274
1001019,50048,18599,49056,37237,154940
1001020,27611,67226,88679,84087,267603
1001021,82675,86323,19926,26282,215206
1001022,34225,59571,5154,19850,118800
1001023,70822,69521,70618,75286,286247
1001024,20169,51422,55023,88355,214969
1001025,71411,81854,72074,85263,310602
1001026,39950,7756,95404,99191,242301
1001027,7526,61104,26190,48139,142959
1001028,9496,96016,73921,2927,182360
1001029,24154,19892,27590,59619,131255
1001030,40966,2203,76481,59355,179005
1001031,62681,71774,58624,47096,240175
1001032,50025,38018,2710,39277,130030
1001033,25373,28382,94399,89719,237873
1001034,33198,24414,64311,44652,166575
1001035,93922,37611,98607,60015,290155
1001036,5470,61149,81948,56782,205349
1001037,65916,27379,57162,50422,200879
1001038,4270,83370,3376,34725,125741
1001039,69837,11450,14663,34519,130469
1001040,67837,79424,39929,53450,240640
1001041,81609,34207,7655,77733,201204
1001042,53769,66268,95769,52806,268612
1001043,68851,67559,88971,6420,231801
1001044,7243,63756,4752,8926,84677
1001045,5024,8424,7395,39806,60649
1001046,62574,1996,84845,19059,168474
1001047,48645,83348,5382,68979,206354
1001048,71759,93036,48808,85402,299005
1001049,37363,10476,96271,36236,180346
1001050,13248,59351,62111,99789,234499
1001051,33250,2003,33104,69639,137996
1001052,56108,90166,22343,25040,193657
1001053,15253,11293,21813,77877,126236
1001054,23486,21663,79952,5515,130616
1001055,97993,97021,7761,73763,276538
1001056,85305,96325,24578,50595,256803
1001057,65379,67875,89696,89465,312415
1001058,126,10127,7059,51206,68518
1001059,15992,61337,7403,65428,150160
1001060,29105,75508,18561,52842,176016
1001061,50770,31352,25310,94827,202259
1001062,39635,83619,98500,64617,286371
1001063,62898,1254,73897,10228,148277
1001064,63845,20145,50319,40633,174942
1001065,63497,47602,26932,60443,198474
1001066,82001,95797,29365,50155,257318
1001067,84523,16462,44599,4478,150062
1001068,71408,69591,92775,32639,266413
1001069,36007,34270,76979,88258,235514
1001070,6234,91688,64426,80495,242843
1001071,79248,29698,96958,84857,290761
1001072,45194,21071,65947,20202,152414
1001073,92452,17948,90966,66536,267902
1001074,20924,36197,56737,43281,157139
1001075,73755,8540,75717,4103,162115
1001076,56174,53191,16147,2927,128439
1001077,85469,92241,63120,54361,295191
1001078,28719,25148,50999,31165,136031
1001079,56354,70282,17178,53818,197632
1001080,81460,82813,11599,47220,223092
1001081,47027,11776,66654,90247,215704
1001082,95417,66650,36239,36488,234794
1001083,1251,26275,37585,8417,73528
1001084,54665,23388,47815,73980,199848
1001085,9572,62638,25894,58559,156663
1001086,27145,521,74358,61191,163215
1001087,44457,87569,38188,12162,182376
1001088,10141,16106,59555,39384,125186
1001089,89137,33748,44853,17691,185429
1001090,90562,62519,69109,89759,311949
1001091,82806,58234,77953,67506,286499
1001092,81427,33431,88003,27005,229866
1001093,75188,93682,93904,66263,329037
1001094,22196,85935,33356,21918,163405
1001095,11702,18453,62508,81188,173851
1001096,61879,16650,64143,31769,174441
1001097,97051,38012,7958,62531,205552
1001098,56814,57421,1866,34615,150716
1001099,81324,69383,20017,51734,222458
1001100,92783,18934,15640,50940,178297
1001101,10608,91678,83400,68927,254613
1001102,67092,26573,20635,63561,177861
1001103,49293,84699,37241,13031,184264
1001104,61490,98754,26931,47321,234496
1001105,22489,65457,58660,31325,177931
1001106,95984,25020,17433,10799,149236
1001107,24935,9085,3616,67214,104850
1001108,99151,40851,28431,3620,172053
1001109,66173,41815,75511,10725,194224
1001110,47410,55732,90247,21000,214389
1001111,94665,52114,53427,83295,283501
1001112,26945,19784,71722,208,118659
1001113,88664,63574,72332,34788,259358
1001114,72869,50029,76411,71411,270720
1001115,52875,76062,22103,97551,248591
1001116,43126,17456,39424,66611,166617
1001117,91873,29720,83462,70356,275411
1001118,57725,70963,23053,23751,175492
1001119,56339,41219,7310,16881,121749
1001120,14557,67218,9158,62975,153908
1001121,44516,62131,90618,46471,243736
1001122,21424,48635,30245,72094,172398
1001123,75979,36927,42830,75792,231528
1001124,88652,25329,94830,9529,218340
1001125,62923,83161,30587,55994,232665
1001126,22982,12654,2088,33749,71473
1001127,46230,3575,85286,95004,230095
1001128,94171,50561,6605,59861,211198
1001129,32458,96074,86971,13841,229344
1001130,24617,67181,92217,63049,247064
1001131,18880,69356,20851,30128,139215
1001132,90420,16335,17799,46551,171105
1001133,13723,61028,36584,89892,201227
1001134,5007,29762,50595,46326,131690
1001135,14541,89790,593,79923,184847
1001136,14549,79600,27021,74799,195969
1001137,68338,50359,23971,25345,168013
1001138,86181,69570,96835,75053,327639
1001139,6279,4444,20019,62539,93281
1001140,10439,50107,14352,57106,132004
1001141,54035,15248,96434,75520,241237
1001142,43383,39611,46918,73358,203270
1001143,10958,32468,36561,18883,98870
1001144,22817,43129,24370,50676,140992
1001145,73510,16866,66784,71200,228360
1001146,43613,39532,12502,73145,168792
1001147,27597,9893,65273,7232,109995
1001148,25623,62654,49629,84914,222820
1001149,26359,45765,41090,72405,185619
1001150,92350,75588,39140,30782,237860
1001151,85666,88566,97247,62989,334468
1001152,99414,98555,4540,75788,278297
1001153,78101,32190,39484,24961,174736
1001154,22610,15959,25661,48481,112711
1001155,82186,1900,20193,35870,140149
1001156,45585,170,26520,17550,89825
1001157,38387,4627,66704,46787,156505
1001158,41428,5740,49004,88892,185064
1001159,84270,42396,96472,243,223381
1001160,97314,79577,54733,6200,237824
1001161,28117,39029,3470,56921,127537
1001162,95494,68701,87998,95243,347436
1001163,22471,15414,65704,77780,181369
1001164,32957,20940,73353,73584,200834
1001165,18358,70052,36726,6710,131846
1001166,34746,53179,16757,91259,195941
1001167,17591,24931,25182,38258,105962
1001168,3390,85572,81483,17489,187934
1001169,80860,44087,14886,90922,230755
1001170,46526,33796,86084,17591,183997
1001171,28096,89021,21935,79547,218599
1001172,70819,95984,1640,8790,177233
1001173,73179,83921,9691,34114,200905
1001174,93820,593,98182,51806,244401
1001175,87500,54362,34751,93497,270110
1001176,21318,4012,50475,46086,121891
1001177,14245,67862,8613,12555,103275
1001178,20182,80592,84459,54958,240191
1001179,84906,35328,34508,41257,195999
1001180,28992,23400,3223,88399,144014
1001181,53228,11862,52085,23457,140632
1001182,31860,70715,2745,18035,123355
1001183,68494,65270,80920,25372,240056
1001184,16562,95074,88840,83227,283703
1001185,18478,64190,5823,59918,148409
1001186,35411,16757,30255,79386,161809
1001187,38273,87235,45273,20634,191415
1001188,17159,52769,42099,34666,146693
1001189,72406,69869,58332,67923,268530
1001190,34421,57882,69128,75408,236839
1001191,30229,1774,39159,4723,75885
1001192,27112,34810,35165,90157,187244
1001193,60164,11584,84276,93820,249844
1001194,16763,79585,95247,39281,230876
1001195,93305,77992,27481,36513,235291
1001196,7323,69974,33494,35819,146610
1001197,36859,21598,6944,3369,68770
1001198,4562,13649,59582,21759,99552
1001199,92977,73732,8057,10786,185552
1001200,64623,90329,46836,21108,222896
1001201,31421,60750,38987,85851,217009
1001202,84539,87177,11339,28387,211442
1001203,13062,56365,98883,65398,233708
1001204,51303,32588,44741,7487,136119
1001205,25791,89235,1746,75507,192279
1001206,6965,8696,55296,74457,145414
1001207,61895,66523,35768,46104,210290
1001208,81905,84275,25264,1137,192581
1001209,48421,15327,90324,11180,165252
1001210,86606,19430,10583,51042,167661
1001211,97551,53087,74889,25655,251182
1001212,854,84248,92962,78602,256666
1001213,79656,50487,33345,66729,230217
1001214,8107,1508,23724,38159,71498
1001215,96910,18595,49969,70593,236067
1001216,44558,90314,29922,85267,250061
1001217,98947,89392,81525,78956,348820
1001218,8167,84882,57655,56523,207227
1001219,54544,16605,17537,66670,155356
1001220,41690,21014,90427,38474,191605
1001221,33883,68175,24357,35216,161631
1001222,67894,72732,4259,47052,191937
1001223,75499,68011,58118,49299,250927
1001224,59014,60390,4036,23486,146926
1001225,41404,31197,46042,89005,207648
1001226,61640,55782,91620,95519,304561
1001227,17197,45870,15560,4780,83407
1001228,48477,1040,76652,84722,210891
1001229,9528,11721,41012,4421,66682
1001230,25412,30636,90626,18568,165242
1001231,23956,31265,8592,99339,163152
1001232,22181,61550,62245,27247,173223
1001233,68314,4795,96415,4728,174252
1001234,50948,37772,64156,19161,172037
1001235,89257,65021,66465,27560,248303
1001236,82213,59362,74983,99741,316299
1001237,3622,52636,74595,19450,150303
1001238,88372,62454,14607,33562,198995
1001239,77388,24453,75920,34415,212176
1001240,45427,17677,46613,18345,128062
1001241,61650,64968,10725,96748,234091
1001242,70274,92649,4794,64955,232672
1001243,50528,45722,65262,61244,222756
1001244,42716,7198,63751,9653,123318
1001245,78178,87041,9790,43638,218647
1001246,41809,69491,20180,16033,147513
1001247,20179,82725,46908,44050,193862
1001248,2608,42918,94853,22038,162417
1001249,72400,42081,14629,70262,199372
1001250,65734,68495,71033,51544,256806
1001251,15804,76498,26106,36336,154744
1001252,7249,30293,54388,50523,142453
1001253,85063,36513,1365,70263,193204
1001254,7765,99130,14947,63453,185295
1001255,49492,72814,14481,29982,166769
1001256,35404,92677,20794,85197,234072
1001257,40908,7131,21434,71362,140835
1001258,95985,31142,37169,22851,187147
1001259,59022,14287,49626,93455,216390
1001260,84131,46207,92806,51733,274877
1001261,86151,32189,63254,61432,243026
1001262,20360,89283,26125,77298,213066
1001263,50510,43210,72041,61278,227039
1001264,61372,67654,88614,62455,280095
1001265,44089,39029,18328,15072,116518
1001266,91833,96015,69180,16178,273206
1001267,27138,34261,95299,39251,195949
1001268,98226,11573,55855,44529,210183
1001269,26884,64849,92402,48426,232561
1001270,20323,71843,87440,43210,222816
1001271,9849,63197,24936,76109,174091
1001272,90834,47042,18298,78353,234527
1001273,45849,9357,7967,48466,111639
1001274,8396,43574,21608,47190,120768
1001275,91860,72294,60695,76252,301101
1001276,80989,62482,81500,32584,257555
1001277,38953,94849,97397,43276,274475
1001278,10250,51590,85437,83666,230943
1001279,74932,51848,59064,63317,249161
1001280,82192,35100,11649,91316,220257
1001281,26669,8996,45445,29548,110658
1001282,12809,62448,20741,64327,160325
1001283,12647,46993,23948,62722,146310
1001284,6581,64869,90113,54995,216558
1001285,12372,26288,65651,84588,188899
1001286,82526,17938,10244,30893,141601
1001287,73068,84401,57883,57361,272713
1001288,24993,28975,36584,57697,148249
1001289,53706,72888,58441,7104,192139
1001290,15992,62270,53256,65878,197396
1001291,26,91733,75929,49251,216939
1001292,41691,31551,10668,22636,106546
1001293,14706,78427,40735,29447,163315
1001294,55823,83578,52586,21911,213898
1001295,78811,6673,86055,46361,217900
1001296,89887,52178,66932,92723,301720
1001297,18070,69441,23332,29343,140186
1001298,26836,91693,55234,59661,233424
1001299,42349,56228,52161,29714,180452
1001300,83515,74633,30242,54693,243083
1001301,27754,22988,80997,60513,192252
1001302,81348,29944,31304,73851,216447
1001303,25816,26303,42548,39558,134225
1001304,94317,58122,43783,31921,228143
1001305,96742,52820,74767,94998,319327
1001306,20779,13666,98276,5789,138510
1001307,29205,50322,66662,52911,199100
1001308,13180,83355,56366,12601,165502
1001309,50255,40898,10528,89324,191005
1001310,63915,25964,3158,50792,143829
1001311,91129,1201,18549,21700,132579
1001312,13330,98825,90467,29423,232045
1001313,15205,24161,73614,54585,167565
1001314,79446,19199,79820,11051,189516
1001315,65315,61289,77192,34460,238256
1001316,89989,39633,74767,61573,265962
1001317,26343,90340,96992,85259,298934
1001318,64063,42898,20582,59078,186621
1001319,58320,60818,66314,49458,234910
1001320,74715,75455,55311,83422,288903
1001321,24347,74696,68294,3361,170698
1001322,93669,98190,49863,2644,244366
1001323,43027,16791,67236,14596,141650
1001324,75081,30030,9950,10233,125294
1001325,50483,17974,28924,56259,153640
1001326,3333,73146,75351,94665,246495
1001327,25495,16955,96895,52565,191910
1001328,14898,68333,53851,87458,224540
1001329,68111,24763,59343,33191,185408
1001330,55336,94141,35042,58986,243505
1001331,87564,15173,73779,36434,212950
1001332,19807,24146,96142,51937,192032
1001333,18644,51618,92797,80147,243206
1001334,19896,25562,23717,15019,84194
1001335,79055,67796,53967,71371,272189
1001336,94883,55430,79419,10472,240204
1001337,9819,53553,2162,78254,143788
1001338,66635,17161,10053,85558,179407
1001339,97374,72018,56237,92583,318212
1001340,51510,10976,99095,88839,250420
1001341,55855,93802,35768,1556,186981
1001342,24842,59000,267,84146,168255
1001343,71913,28931,29652,74639,205135
1001344,32142,80256,34904,41783,189085
1001345,45523,31766,45600,50211,173100
1001346,40525,7365,7760,42237,97887
1001347,98860,17011,41788,71740,229399
1001348,55504,96656,60705,233,213098
1001349,59654,78911,54611,30316,223492
1001350,8480,26462,92424,33943,161309
1001351,53399,53075,66339,45138,217951
1001352,2166,95513,30781,53637,182097
1001353,55516,79871,32604,38089,206080
1001354,15696,88714,434,8435,113279
1001355,72811,75659,54199,96452,299121
1001356,25485,86107,76567,8973,197132
1001357,14744,14397,12579,76729,118449
1001358,99389,42816,67043,27849,237097
1001359,36299,12868,28041,93639,170847
1001360,75080,85399,88193,68710,317382
1001361,94134,55554,84783,30760,265231
1001362,89045,98567,52029,61995,301636
1001363,96238,12075,63912,31425,203650
1001364,90865,17373,46045,72118,226401
1001365,95057,11168,39548,10455,156228
1001366,61455,39452,29183,41351,171441
1001367,4158,76828,64740,94391,240117
1001368,60634,70859,37496,17724,186713
1001369,43988,77925,73190,2013,197116
1001370,66490,29886,99884,15878,212138
1001371,24662,23505,26161,32288,106616
1001372,6738,184,8781,78368,94071
1001373,18662,87737,46622,26413,179434
1001374,36524,49204,52816,6646,145190
1001375,53183,10290,74055,29097,166625
1001376,2731,26576,27063,68756,125126
1001377,30463,45116,6774,59416,141769
1001378,26709,3229,68811,95501,194250
1001379,39734,78856,78564,74971,272125
1001380,8938,45291,34666,85604,174499
1001381,17000,35535,32375,37954,122864
1001382,56316,32285,96937,62679,248217
1001383,26599,22516,26252,31079,106446
1001384,7677,39898,87489,32047,167111
1001385,79353,77580,71444,73131,301508
1001386,77466,82137,57103,75106,291812
1001387,70465,32564,80414,29698,213141
1001388,48527,81939,94427,42497,267390
1001389,91222,79761,28305,86503,285791
1001390,23254,41916,54516,72400,192086
1001391,34687,22394,54053,50406,161540
1001392,45131,39982,82670,1338,169121
1001393,52015,45630,41218,15562,154425
1001394,1786,31527,14244,63736,111293
1001395,16627,5532,22292,26496,70947
1001396,55352,34498,78547,70492,238889
1001397,86005,2135,86857,71066,246063
1001398,25726,39606,75176,58278,198786
1001399,40468,40903,64329,85522,231222
1001400,94812,47234,89487,54973,286506
1001401,29688,23009,35650,88800,177147
1001402,33999,95441,2760,99689,231889
1001403,62500,40547,854,40385,144286
1001404,15260,8886,4672,25440,54258
1001405,10875,98067,1888,93069,203899
1001406,77347,32692,50782,78647,239468
1001407,51010,16110,58890,41350,167360
1001408,30754,39785,507,32219,103265
1001409,30661,77280,97357,12934,218232
1001410,41489,33261,38538,44049,157337
1001411,70465,22353,23093,38688,154599
1001412,54715,86292,80008,68913,289928
1001413,52603,77320,71766,47654,249343
1001414,28133,48260,60088,40590,177071
1001415,91685,37810,30230,18968,178693
1001416,11564,67067,27392,17405,123428
1001417,73461,47188,77337,15892,213878
1001418,16565,35239,44753,35921,132478
1001419,8943,67517,80594,95473,252527
1001420,88007,92756,4544,11178,196485
1001421,6442,61345,11294,56838,135919
1001422,12520,12486,91328,33930,150264
1001423,17568,85024,12307,14057,128956
1001424,87816,43181,52125,98413,281535
1001425,797,80770,4453,40889,126909
1001426,45331,76841,14231,88833,225236
1001427,6546,53853,36044,20868,117311
1001428,62042,89086,62597,51817,265542
1001429,36503,78935,10514,55846,181798
1001430,49472,85197,68725,77807,281201
1001431,9978,30918,81611,69445,191952
1001432,35981,28536,57116,64895,186528
1001433,75023,67770,90556,17427,250776
1001434,64876,22879,34870,70007,192632
1001435,57510,18338,73758,44044,193650
1001436,28781,8163,71023,48584,156551
1001437,56429,90776,19878,42022,209105
1001438,81668,46803,4404,39472,172347
1001439,37129,14165,80933,14196,146423
1001440,91489,80662,63649,74011,309811
1001441,1083,74033,98176,52607,225899
1001442,47927,18104,66591,2219,134841
1001443,61014,89912,84479,81143,316548
1001444,20135,6032,25400,8230,59797
1001445,38747,74004,22425,7315,142491
1001446,31256,63446,13507,17803,126012
1001447,22306,93296,77526,7703,200831
1001448,41428,53077,15547,1777,111829
1001449,29771,44453,83773,3415,161412
1001450,62565,33151,71888,57404,225008
1001451,67567,91520,60501,72850,292438
1001452,57147,66203,92701,63913,279964
1001453,49801,89077,10290,99356,248524
1001454,2551,10993,21076,9537,44157
1001455,52460,70579,92465,8389,223893
1001456,93264,45835,70101,9540,218740
1001457,42393,8130,46310,83995,180828
1001458,99098,95021,35985,67875,297979
1001459,60581,21569,18564,26694,127408
1001460,55252,67292,18324,30838,171706
1001461,18229,84249,76151,73117,251746
1001462,12211,81190,96859,84238,274498
1001463,86299,87591,23975,14376,212241
1001464,43099,91535,52847,37457,224938
1001465,35693,79287,52965,70009,237954
1001466,77525,76762,85558,25742,265587
1001467,65131,4510,89344,71099,230084
1001468,90651,3849,97603,92861,284964
1001469,79593,36783,91856,78699,286931
1001470,57614,77273,91403,50376,276666
1001471,83405,43531,18537,48157,193630
1001472,8255,91573,13966,58995,172789
1001473,16746,7131,78991,3936,106804
1001474,48317,20834,48936,86637,204724
1001475,5817,878,92392,6894,105981
1001476,65583,24742,56599,15560,162484
1001477,86953,50832,17576,83587,238948
1001478,51600,22323,81851,15853,171627
1001479,33968,937,94155,89034,218094
1001480,78380,9466,56771,9466,154083
1001481,78702,64258,26888,80965,250813
1001482,7779,55053,87396,56731,206959
1001483,67272,97545,62129,51377,278323
1001484,89738,76756,30125,99035,295654
1001485,53757,7132,98465,16735,176089
1001486,58606,15845,38074,4256,116781
1001487,99264,94412,74619,70137,338432
1001488,36516,27533,2575,84593,151217
1001489,71988,45711,55515,8831,182045
1001490,39498,64760,256,29042,133556
1001491,2302,64275,36309,65465,168351
1001492,57008,84330,20992,48687,211017
1001493,76814,992,36864,56383,171053
1001494,13796,39582,67926,5504,126808
1001495,89903,89865,93281,66161,339210
1001496,12105,30813,22792,37552,103262
1001497,23958,21628,7209,77223,130018
1001498,55254,78962,66320,88922,289458
1001499,39986,33873,52882,78377,205118
1001500,47416,58471,85350,34147,225384
1001501,1417,22235,56340,89807,169799
1001502,8980,72202,71556,26120,178858
1001503,22616,99415,23114,79886,225031
1001504,87601,79797,63229,27375,258002
1001505,34443,78635,26659,97860,237597
1001506,87079,87982,30328,911,206300
1001507,67690,63841,81492,84883,297906
1001508,905,79461,91612,19466,191444
1001509,11970,29374,28299,5701,75344
1001510,38369,66843,28907,42988,177107
1001511,82311,69110,75718,46613,273752
1001512,562,15404,42279,92440,150685
1001513,36252,54397,48205,82304,221158
1001514,70281,81171,17055,61404,229911
1001515,50857,35759,60021,48225,194862
1001516,9169,13313,20094,4297,46873
1001517,2317,9458,94918,21336,128029
1001518,65483,19489,92168,90236,267376
1001519,4564,82706,38299,7746,133315
1001520,88790,44016,47520,19552,199878
1001521,88850,39507,5338,51433,185128
1001522,10197,63129,83269,78378,234973
1001523,49468,31304,4623,38275,123670
1001524,85579,36542,59547,115,181783
1001525,59905,80745,38942,42962,222554
1001526,25788,84052,70454,44966,225260
1001527,89334,74025,57006,59319,279684
1001528,53365,64385,11515,95896,225161
1001529,91370,42001,69798,23610,226779
1001530,21187,11595,79653,94471,206906
1001531,43297,69007,67633,68517,248454
1001532,4200,15478,81883,49956,151517
1001533,31360,44234,96682,75897,248173
1001534,12709,17435,74833,48711,153688
1001535,53074,46481,41426,39713,180694
1001536,5725,87378,49072,37345,179520
1001537,7730,19530,81575,45368,154203
1001538,37691,38731,10990,25778,113190
1001539,8295,72563,11940,25873,118671
1001540,41089,2180,67062,57,110388
1001541,67398,10508,72059,73337,223302
1001542,14021,89328,72376,36938,212663
1001543,87492,74916,66770,19805,248983
1001544,7289,71598,76458,9593,164938
1001545,51306,74681,28868,41970,196825
1001546,989,14423,87407,67331,170150
1001547,31954,7798,44613,70085,154450
1001548,64051,12889,43353,12202,132495
1001549,22385,42773,58295,81803,205256
1001550,2073,63131,14975,57988,138167
1001551,92241,63962,85942,34036,276181
1001552,37296,6293,43472,90827,177888
1001553,92375,92897,97985,95896,379153
1001554,67709,37187,3224,58537,166657
1001555,15435,66516,79641,82220,243812
1001556,81185,50166,6823,33282,171456
1001557,16906,48722,46835,17768,130231
1001558,36999,31914,70557,39891,179361
1001559,73465,55823,51493,88675,269456
1001560,49267,17778,1348,81151,149544
1001561,48882,81009,99904,12938,242733
1001562,27926,71502,14167,289,113884
1001563,60541,72267,11668,40822,185298
1001564,51040,31672,25236,46478,154426
1001565,51086,48440,43030,1615,144171
1001566,15893,29815,87387,57831,190926
1001567,93781,74089,46733,3242,217845
1001568,19932,69046,66485,79105,234568
1001569,14269,68550,34243,42580,159642
1001570,47157,80986,32657,84352,245152
1001571,41701,58840,94936,38433,233910
1001572,92392,52399,96984,45641,287416
1001573,78127,75150,35551,16989,205817
1001574,14278,74186,55337,47210,191011
1001575,76793,15595,48004,35458,175850
1001576,67867,61535,20217,74242,223861
1001577,60416,19472,96492,46448,222828
1001578,16442,23760,65215,74404,179821
1001579,14875,90033,11039,2976,118923
1001580,12831,9287,93598,84142,199858
1001581,35684,15771,33538,80452,165445
1001582,77966,54844,5874,5316,144000
1001583,79994,52507,35745,58021,226267
1001584,53012,85726,75467,25192,239397
1001585,77098,14329,46549,80951,218927
1001586,59374,36246,54544,96744,246908
1001587,40970,86828,9569,1835,139202
1001588,8273,48219,13450,44298,114240
1001589,87451,77856,58330,43821,267458
1001590,59826,58230,94480,68559,281095
1001591,36428,91043,45691,97276,270438
1001592,54802,99255,14283,40767,209107
1001593,97923,54780,75145,34275,262123
1001594,53557,76430,35757,53641,219385
1001595,66875,80964,39327,39936,227102
1001596,34624,35708,86010,44191,200533
1001597,63216,7738,7257,96029,174240
1001598,84961,15750,71213,54283,226207
1001599,74172,87698,2138,32426,196434
1001600,30303,84531,85057,65646,265537
1001601,13274,84739,82603,89237,269853
1001602,25168,16737,89273,15100,146278
1001603,45397,35700,96086,35061,212244
1001604,9389,72580,17203,83311,182483
1001605,79738,40194,19294,71250,210476
1001606,22377,41857,38363,88450,191047
1001607,68312,68598,35691,51010,223611
1001608,26722,91556,37177,61385,216840
1001609,50152,26520,74196,23888,174756
1001610,46741,96677,31538,3090,178046
1001611,90742,88142,40983,6753,226620
1001612,39978,39262,72797,20819,172856
1001613,32018,38649,75634,70292,216593
1001614,9254,4888,53383,97532,165057
1001615,13451,71603,33346,21073,139473
1001616,43916,97252,4950,6101,152219
1001617,40402,33085,54125,40117,167729
1001618,80003,18520,11654,60885,171062
1001619,25612,36758,26161,75316,163847
1001620,58767,85306,96258,95680,336011
1001621,59706,29184,35608,41915,166413
1001622,52922,92866,66934,83887,296609
1001623,692,58067,38528,29307,126594
1001624,50387,10458,56070,59682,176597
1001625,59376,49783,27194,95160,231513
1001626,92576,78664,20010,5859,197109
1001627,76444,88912,2292,19308,186956
1001628,19010,47498,33809,19417,119734
1001629,31252,38848,48075,26894,145069
1001630,92195,14782,83189,60250,250416
1001631,57300,13913,26649,17157,115019
1001632,7439,87779,29189,2248,126655
1001633,4251,4502,17668,76927,103348
1001634,31764,10074,41173,64998,148009
1001635,8626,94404,6589,81011,190630
1001636,46893,81170,33244,80891,242198
1001637,67364,21316,9697,73742,172119
1001638,76955,83493,67324,24945,252717
1001639,44011,81977,59417,25035,210440
1001640,19491,36259,69993,41255,166998
1001641,5759,69775,24012,93113,192659
1001642,57057,80588,91077,62963,291685
1001643,85026,64144,86937,79648,315755
1001644,8311,87269,126,56028,151734
1001645,37727,86430,14320,79772,218249
1001646,24284,99947,34350,28865,187446
1001647,95899,57430,80525,72060,305914
1001648,69610,64895,91453,32869,258827
1001649,76748,43091,89681,71000,280520
1001650,35092,59534,50555,50627,195808
1001651,44424,10046,70126,80261,204857
1001652,99357,73770,49143,23928,246198
1001653,36764,36576,57697,10648,141685
1001654,84351,33161,33561,90600,241673
1001655,71713,4169,52738,91640,220260
1001656,32963,89993,56393,55054,234403
1001657,91727,85070,95579,49358,321734
1001658,34106,67478,97921,54247,253752
1001659,79483,19562,60930,70110,230085
1001660,39845,32508,56536,27380,156269
1001661,89314,38218,24631,26578,178741
1001662,86504,81001,69488,16943,253936
1001663,24674,86181,49081,40152,200088
1001664,55659,51643,39649,61944,208895
1001665,57079,89995,9012,65084,221170
1001666,41348,32140,92088,33664,199240
1001667,11451,46361,72513,81091,211416
1001668,19924,5892,45689,4751,76256
1001669,9487,85625,82025,5733,182870
1001670,51056,90183,78861,84146,304246
1001671,2725,57262,69620,70301,199908
1001672,14560,30398,56956,97886,199800
1001673,6899,67962,65881,15970,156712
1001674,87115,43610,71631,90038,292394
1001675,26529,5568,14764,86624,133485
1001676,1564,33559,57498,92230,184851
1001677,95473,77540,88527,25593,287133
1001678,70103,21546,39761,21555,152965
1001679,59897,7531,41622,15329,124379
1001680,95473,27248,68491,48872,240084
1001681,38419,55304,15465,69165,178353
1001682,17201,71006,58378,82755,229340
1001683,37714,72240,45977,10618,166549
1001684,77949,29994,5597,48886,162426
1001685,53906,56868,13023,64546,188343
1001686,77721,37720,18120,35721,169282
1001687,51620,45495,36007,87999,221121
1001688,90457,98732,62251,48817,300257
1001689,41596,66037,56227,48434,212294
1001690,28628,11553,63292,17728,121201
1001691,31759,41301,20991,19536,113587
1001692,11169,84277,87387,9506,192339
1001693,53654,93625,77211,91196,315686
1001694,54201,56098,48593,93930,252822
1001695,60266,95600,27683,26154,209703
1001696,7575,58915,42647,91957,201094
1001697,19293,53767,66920,36340,176320
1001698,16754,80323,10226,97540,204843
1001699,11253,88912,29624,9685,139474
1001700,23083,14717,25227,37469,100496
1001701,41775,63144,84637,16589,206145
1001702,41210,46889,75555,75838,239492
1001703,35070,81659,32432,14934,164095
1001704,96654,60439,27554,61111,245758
1001705,51133,96251,10467,79820,237671
1001706,42615,73105,27183,44846,187749
1001707,13896,483,2673,65382,82434
1001708,38430,30895,59922,93363,222610
1001709,86387,15406,18490,91650,211933
1001710,75185,75021,59996,442,210644
1001711,90843,2484,18404,11641,123372
1001712,48900,21728,58766,11658,141052
1001713,51627,47645,53115,68968,221355
1001714,74467,20495,30870,85330,211162
1001715,3205,31004,37025,23197,94431
1001716,93607,23494,1643,2088,120832
1001717,49208,68780,92679,59480,270147
1001718,54002,6737,69180,68946,198865
1001719,68761,5041,6779,43710,124291
1001720,79541,91727,39997,22029,233294
1001721,36678,28407,59041,70229,194355
1001722,11793,24518,16103,22619,75033
1001723,91603,78328,32432,42087,244450
1001724,89681,69706,80467,94315,334169
1001725,69362,23405,42751,68889,204407
1001726,16,21294,98248,34600,154158
1001727,42011,10869,2045,59069,113994
1001728,26086,48156,85515,94832,254589
1001729,78515,38547,68456,47542,233060
1001730,62827,73066,14117,21023,171033
1001731,92020,92035,80130,64231,328416
1001732,96292,18433,75805,46543,237073
1001733,55932,95870,57715,88132,297649
1001734,88070,65613,50663,42515,246861
1001735,41875,42144,9177,22262,115458
1001736,10414,89096,70463,95340,265313
1001737,2652,57754,71850,86877,219133
1001738,79929,64318,81599,24405,250251
1001739,88770,94347,32800,3918,219835
1001740,91438,76908,31328,77760,277434
1001741,40853,15542,46759,20952,124106
1001742,9711,59701,87127,81100,237639
1001743,82106,44701,99303,53263,279373
1001744,56369,8844,27664,69635,162512
1001745,82211,99360,27940,76577,286088
1001746,5975,55798,60157,50811,172741
1001747,582,2533,17903,81437,102455
1001748,97794,34793,86167,39249,258003
1001749,8216,39062,78562,87882,213722
1001750,42670,45924,58167,92250,239011
1001751,90980,89090,76124,86530,342724
1001752,73520,64001,11943,171,149635
1001753,27638,90891,80436,82202,281167
1001754,53431,54950,83131,17557,209069
1001755,24279,20652,61022,42200,148153
1001756,96144,19628,92183,32883,240838
1001757,95889,65735,34953,3003,199580
1001758,87975,86471,96043,83702,354191
1001759,11043,40559,20513,65861,137976
1001760,9306,35849,89643,7617,142415
1001761,8469,91265,36874,38361,174969
1001762,65653,44260,36824,15977,162714
1001763,22016,35642,62668,47711,168037
1001764,35845,21434,88665,79862,225806
1001765,97528,69330,56825,23366,247049
1001766,17828,46571,28473,31716,124588
1001767,87188,80672,61579,78433,307872
1001768,68928,78226,60815,78778,286747
1001769,86094,83913,30641,86017,286665
1001770,4062,61948,69585,48957,184552
1001771,43821,30734,95842,86377,256774
1001772,30243,25858,23098,56517,135716
1001773,98591,42106,91218,69345,301260
1001774,19703,39510,84908,72291,216412
1001775,92588,5133,93274,70416,261411
1001776,1385,54556,42033,61498,159472
1001777,15357,47771,74505,75945,213578
1001778,35593,22544,62279,36125,156541
1001779,95298,24221,95262,92079,306860
1001780,99105,69604,35919,36179,240807
1001781,20391,27551,22336,87107,157385
1001782,38490,19136,45111,50091,152828
1001783,3130,76809,11838,15551,107328
1001784,16112,54307,85736,7734,163889
1001785,17233,43787,87278,12143,160441
1001786,84461,94184,63384,90315,332344
1001787,70033,1008,77326,64872,213239
1001788,25073,61622,95925,50646,233266
1001789,27472,52869,18959,64363,163663
1001790,13438,49237,79729,28391,170795
1001791,15882,82718,96888,64340,259828
1001792,58164,76995,63309,25387,223855
1001793,24398,14533,75201,29803,143935
1001794,17230,12022,83545,90342,203139
1001795,2833,99714,40731,86083,229361
1001796,59863,34744,49130,20603,164340
1001797,783,63204,965,37605,102557
1001798,84079,78758,61245,58738,282820
1001799,34911,39946,91286,35745,201888
1001800,44313,65032,41593,30705,181643
1001801,80014,78854,88316,92964,340148
1001802,75237,7136,83660,63000,229033
1001803,45820,68725,22921,86111,223577
1001804,96874,87023,42002,66055,291954
1001805,73099,47045,74905,11816,206865
1001806,14789,11263,79736,72744,178532
1001807,50075,46799,43829,82773,223476
1001808,26249,1218,75214,31720,134401
1001809,95167,54875,58405,30949,239396
1001810,26862,34203,44933,41922,147920
1001811,8068,42286,36172,32929,119455
1001812,39247,18983,71664,63876,193770
1001813,60023,69408,40042,78995,248468
1001814,48275,52215,56523,24348,181361
1001815,91180,39300,36650,982,168112
1001816,55078,61890,42270,42278,201516
1001817,96317,87019,90391,25845,299572
1001818,1566,57203,78933,39171,176873
1001819,47315,16868,30684,26587,121454
1001820,77890,56983,81523,47957,264353
1001821,240,26908,94187,1192,122527
1001822,43430,66002,61639,21573,192644
1001823,68007,29985,88369,29237,215598
1001824,84339,38745,97386,55572,276042
1001825,31967,94992,23817,17249,168025
1001826,77756,49369,435,56432,183992
1001827,79818,4768,22489,41999,149074
1001828,6069,4640,92096,45434,148239
1001829,59346,29390,12719,84158,185613
1001830,11202,8416,9904,15903,45425
1001831,29917,20502,10980,88924,150323
1001832,39779,6635,49972,2811,99197
1001833,71473,1021,82193,24093,178780
1001834,29476,34628,12696,84590,161390
1001835,31404,49281,34648,23108,138441
1001836,99603,66076,72424,23312,261415
1001837,65244,8507,31211,54594,159556
1001838,67828,24990,5324,53110,151252
1001839,87951,10932,95110,3565,197558
1001840,18662,11978,31659,4552,66851
1001841,67779,86862,17011,90432,262084
1001842,74038,21136,38799,77711,211684
1001843,82447,43198,83872,12280,221797
1001844,77389,61686,78799,58849,276723
1001845,34993,64177,34747,64133,198050
1001846,42022,11417,12779,9236,75454
1001847,28484,98544,18912,95363,241303
1001848,49343,87071,36257,1938,174609
1001849,20195,88207,84153,42183,234738
1001850,20927,86656,65847,89561,262991
1001851,45725,8431,53188,95412,202756
1001852,70539,96462,96157,69877,333035
1001853,32196,94090,92199,3627,222112
1001854,45451,4572,97074,44364,191461
1001855,68213,97451,6902,3134,175700
1001856,70914,46594,73173,79054,269735
1001857,61861,37216,87257,62175,248509
1001858,78045,27041,77434,6538,189058
1001859,28233,21445,73141,73830,196649
1001860,42135,18156,43047,20932,124270
1001861,99090,78279,36156,65456,278981
1001862,64926,27192,87381,7372,186871
1001863,7691,28291,74246,64568,174796
1001864,10027,97348,7304,84883,199562
1001865,23337,81466,70033,31054,205890
1001866,88784,63481,87567,39556,279388
1001867,18767,70049,32028,23873,144717
1001868,51223,58210,68512,93,178038
1001869,56041,90216,7201,41974,195432
1001870,79190,74472,61892,74881,290435
1001871,94902,86997,47436,88789,318124
1001872,7603,62551,27540,5990,103684
1001873,96907,70904,83075,31229,282115
1001874,77220,12267,43770,65159,198416
1001875,37234,61406,81924,50926,231490
1001876,10458,39857,74964,1569,126848
1001877,45037,1293,24674,70429,141433
1001878,72690,82271,10240,18980,184181
1001879,54951,4090,84035,55831,198907
1001880,11677,29723,38813,56736,136949
1001881,45490,56445,58765,52914,213614
1001882,54637,20702,12610,62297,150246
1001883,18215,35326,80126,39955,173622
1001884,92160,27766,43714,54443,218083
1001885,44522,82227,76567,68707,272023
1001886,96330,66958,23400,98958,285646
1001887,47198,16924,37448,70094,171664
1001888,10916,9957,69763,83370,174006
1001889,23982,81016,36121,4882,146001
1001890,83366,5155,98778,15600,202899
1001891,66736,98091,91893,85558,342278
1001892,68866,13587,34952,24490,141895
1001893,2127,21041,92425,30524,146117
1001894,82218,16237,1191,95387,195033
1001895,87041,96729,21872,78510,284152
1001896,56434,8885,67774,68413,201506
1001897,54014,7324,87611,41600,190549
1001898,79459,96365,69891,42177,287892
1001899,22204,35836,97769,67185,222994
1001900,88734,63426,22413,20444,195017
1001901,55664,19449,23345,94717,193175
1001902,7914,49201,4272,79404,140791
1001903,46682,9566,43782,97228,197258
1001904,44525,1615,41003,79815,166958
1001905,76196,69576,18859,59087,223718
1001906,81344,36170,33026,75147,225687
1001907,18688,9832,91844,52952,173316
1001908,16012,66512,28543,95299,206366
1001909,4498,98444,71639,98252,272833
1001910,90498,88955,21317,73538,274308
1001911,73135,80390,57695,75229,286449
1001912,66768,17722,16694,56961,158145
1001913,6791,96498,70560,94227,268076
1001914,3752,50390,30246,80625,165013
1001915,37422,21831,92753,38551,190557
1001916,22052,74696,57653,12423,166824
1001917,60378,11051,81627,9690,162746
1001918,41588,18342,91856,43310,195096
1001919,2952,63859,62220,8208,137239
1001920,99129,97276,9778,18916,225099
1001921,35550,96729,79176,31947,243402
1001922,24540,30406,26182,44233,125361
1001923,99385,51687,63930,91243,306245
1001924,93930,4342,52557,97889,248718
1001925,86283,72806,31246,73679,264014
1001926,61174,44117,19957,36897,162145
1001927,39443,32917,99270,25694,197324
1001928,18997,23973,53402,83554,179926
1001929,76363,39405,95746,26486,238000
1001930,91675,66578,86187,36063,280503
1001931,60688,17122,41816,67548,187174
1001932,26950,81845,12415,16097,137307
1001933,22583,4747,92648,8481,128459
1001934,2591,9916,77750,48703,138960
1001935,70830,86675,52464,4342,214311
1001936,74936,53570,33010,27873,189389
1001937,69733,78244,97129,22973,268079
1001938,73087,82013,452,20496,176048
1001939,45396,808,78533,92364,217101
1001940,37148,75237,53357,16909,182651
1001941,74807,61317,1098,8442,145664
1001942,64975,48825,93453,25140,232393
1001943,76902,97902,534,29445,204783
1001944,44624,82817,6192,33257,166890
1001945,51884,68209,43765,98146,262004
1001946,7742,32254,98181,32779,170956
1001947,91198,37297,40460,41652,210607
1001948,6717,33971,27110,83265,151063
1001949,72618,3718,97678,24165,198179
1001950,32803,27609,32305,77048,169765
1001951,63367,76891,95514,19422,255194
1001952,4262,90145,80386,94952,269745
1001953,66291,90373,63692,75459,295815
1001954,44263,70890,56802,84045,256000
1001955,94044,64588,12767,21854,193253
1001956,54284,29240,53633,2263,139420
1001957,23519,18273,5118,53330,100240
1001958,25956,72089,6596,24571,129212
1001959,27922,88272,48822,44759,209775
1001960,60165,65070,32629,93395,251259
1001961,38179,27600,56411,95069,217259
1001962,49338,81117,58020,2182,190657
1001963,25774,57261,616,22239,105890
1001964,74690,42588,33578,66227,217083
1001965,29926,19261,78484,68842,196513
1001966,32217,60516,25102,50440,168275
1001967,5159,88516,8667,19169,121511
1001968,76910,34059,65616,53195,229780
1001969,75848,34506,67076,55869,233299
1001970,25235,78620,53699,32321,189875
1001971,9137,66571,72840,16067,164615
1001972,93379,68440,45786,4316,211921
1001973,95521,83642,8607,9917,197687
1001974,7732,16725,5155,13734,43346
1001975,4676,77080,60820,54495,197071
1001976,10884,55906,51175,33421,151386
1001977,72815,46992,26767,4469,151043
1001978,76812,66945,78857,14905,237519
1001979,32298,56205,11279,70084,169866
1001980,32970,94096,59784,88439,275289
1001981,12446,42934,20325,28725,104430
1001982,17741,73424,82111,24076,197352
1001983,73686,45375,27113,22759,168933
1001984,89331,77911,6843,61994,236079
1001985,37184,39,74926,67856,180005
1001986,67861,39818,579,77951,186209
1001987,40853,52032,63241,18257,174383
1001988,8417,75792,6149,9315,99673
1001989,90010,62769,15787,6266,174832
1001990,90039,62295,97991,48037,298362
1001991,15946,98267,87467,80548,282228
1001992,30302,97247,10785,34589,172923
1001993,25682,31886,86722,36228,180518
1001994,5458,1611,83629,93944,184642
1001995,41056,82312,90546,27154,241068
1001996,47530,50013,82958,23046,203547
1001997,90271,17143,98583,49185,255182
1001998,77446,59491,9331,30840,177108
1001999,29328,22024,29702,90666,171720
1002000,92971,44734,57846,27079,222630
1002001,66349,38409,43569,29495,177822
1002002,37673,52178,94309,45946,230106
1002003,21763,32711,95031,87621,237126
1002004,7921,79804,68147,27172,183044
1002005,14333,61152,94754,94342,264581
1002006,39832,95193,68856,25718,229599
1002007,63163,92045,88856,95334,339398
1002008,6317,68957,60652,28299,164225
1002009,12180,6115,40067,34848,93210
1002010,72000,97296,30868,52356,252520
1002011,2657,7373,60907,95044,165981
1002012,39073,54020,84022,35962,213077
1002013,5804,94205,33865,47477,181351
1002014,41183,27458,5679,95468,169788
1002015,5031,84202,14509,78214,181956
1002016,82944,47934,89424,5702,226004
1002017,8596,79606,73512,63445,225159
1002018,82283,79962,15460,2630,180335
1002019,67106,55466,42187,28464,193223
1002020,85550,10122,83465,36278,215415
1002021,49293,41675,51559,50242,192769
1002022,82279,19789,22069,31092,155229
1002023,698,16526,31413,33661,82298
1002024,31444,9827,67217,87215,195703
1002025,99823,69150,36731,74864,280568
1002026,37899,57057,94623,30348,219927
1002027,25303,74865,90841,6485,197494
1002028,1072,78007,38756,49198,167033
1002029,87208,93640,86109,60989,327946
1002030,53427,8349,36488,7180,105444
1002031,3801,96032,86735,37278,223846
1002032,31372,75249,78853,58884,244358
1002033,56040,99509,46468,8784,210801
1002034,37673,55591,603,19557,113424
1002035,45295,72915,86611,12759,217580
1002036,74101,5832,38294,20512,138739
1002037,98435,33567,50237,7126,189365
1002038,62282,96914,93073,42995,295264
1002039,38098,35691,23259,91121,188169
1002040,21233,20567,72402,9013,123215
1002041,73508,98375,86166,7602,265651
1002042,44019,29291,14592,26635,114537
1002043,63223,78245,74930,97665,314063
1002044,75524,52791,75854,72019,276188
1002045,37133,49431,46383,67406,200353
1002046,32334,48474,77905,53641,212354
1002047,51929,26110,16298,68379,162716
1002048,17177,58220,82438,48635,206470
1002049,40568,42598,75154,62596,220916
1002050,9284,15248,9090,42980,76602
1002051,17636,7451,26393,93139,144619
1002052,15713,98592,74644,92220,281169
1002053,80877,76944,45927,71966,275714
1002054,63269,29937,94759,35964,223929
1002055,20878,99076,29705,67778,217437
1002056,12768,29426,9172,41946,93312
1002057,31756,19166,92137,58517,201576
1002058,93566,33908,83557,49327,260358
1002059,88177,44478,17950,59853,210458
1002060,81583,37347,58813,28684,206427
1002061,41817,95630,92844,11576,241867
1002062,73185,14678,70277,43852,201992
1002063,48997,79184,4890,77455,210526
1002064,33407,83946,14860,17716,149929
1002065,65238,16441,89899,90426,262004
1002066,72384,82347,12183,39923,206837
1002067,83903,11438,21946,23676,140963
1002068,55368,87434,80617,81838,305257
1002069,70859,3128,38314,53561,165862
1002070,15650,7192,79543,90378,192763
1002071,12511,64611,47540,88785,213447
1002072,32858,33511,69957,73506,209832
1002073,55230,68582,51044,94795,269651
1002074,25130,17373,69083,19875,131461
1002075,60176,34038,66503,28208,188925
1002076,73540,6931,38591,12836,131898
1002077,78861,92330,29698,76084,276973
1002078,93711,77897,85555,34162,291325
1002079,38682,69551,95101,45350,248684
1002080,21643,3818,91241,2431,119133
1002081,18623,69064,63222,45635,196544
1002082,81291,88932,8491,18931,197645
1002083,92407,98824,75612,3083,269926
1002084,88544,54224,6943,83606,233317
1002085,2941,24615,19994,44252,91802
1002086,23837,83804,39264,7968,154873
1002087,67290,93144,33655,64715,258804
1002088,76425,49601,93684,72592,292302
1002089,44698,37093,43446,80264,205501
1002090,63259,34387,13906,9565,121117
1002091,89127,58837,66232,54852,269048
1002092,84492,24334,1862,46824,157512
1002093,72799,80249,47639,10037,210724
1002094,90209,33603,65351,16956,206119
1002095,56668,39969,7965,83580,188182
1002096,62537,76137,65177,56145,259996
1002097,80675,53063,19131,32846,185715
1002098,77378,77375,16059,23149,193961
1002099,46294,43564,34544,33336,157738
1002100,13739,67544,71993,97820,251096
1002101,91665,28332,79069,34825,233891
1002102,94304,97290,54066,44846,290506
1002103,61900,27849,23754,69336,182839
1002104,38104,92122,11811,17507,159544
1002105,8304,44044,40728,83454,176530
1002106,4784,13430,5686,27585,51485
1002107,34915,48111,23746,7334,114106
1002108,9688,96558,42118,91108,239472
1002109,52062,34644,46614,75053,208373
1002110,48650,98036,77861,40011,264558
1002111,5321,37555,62748,78130,183754
1002112,81665,17473,32755,36124,168017
1002113,79410,34464,84947,43180,242001
1002114,34049,96237,87326,76347,293959
1002115,2113,80428,71433,23029,177003
1002116,13245,1888,11462,73325,99920
1002117,92913,40091,16854,30109,179967
1002118,13254,51460,67036,84925,216675
1002119,9964,74739,84703,58459,227865
1002120,41141,46623,13479,16094,117337
1002121,66937,13269,15029,46156,141391
1002122,13724,27679,83819,91466,216688
1002123,13129,93418,7590,34695,148832
1002124,59642,46156,1589,66795,174182
1002125,36413,20599,91720,6935,155667
1002126,57289,14071,55142,31077,157579
1002127,21151,79369,57277,85561,243358
1002128,44793,88297,62745,18856,214691
1002129,98356,22285,71117,17666,209424
1002130,53323,57950,78450,22575,212298
1002131,63754,1531,45217,58920,169422
1002132,65474,43890,10537,98355,218256
1002133,62415,98403,42144,91355,294317
1002134,52158,23712,56794,64875,197539
1002135,63318,39007,4277,37052,143654
1002136,23065,61424,81116,79664,245269
1002137,59885,33477,48900,83123,225385
1002138,18456,62323,97623,31787,210189
1002139,84280,2454,85961,53039,225734
1002140,99094,7404,94853,25052,226403
1002141,98651,57762,3482,91843,251738
1002142,94522,8033,2223,71127,175905
1002143,64731,29354,63232,48809,206126
1002144,18260,23995,24169,17591,84015
1002145,83653,98060,37102,88312,307127
1002146,30975,90217,55412,73091,249695
1002147,18617,9291,79737,42352,149997
1002148,32956,35253,31438,10787,110434
1002149,33041,15257,89967,78862,217127
1002150,52398,70209,45311,23476,191394
1002151,14764,11234,3314,92127,121439
1002152,59431,45812,94970,2445,202658
1002153,36696,22953,1412,66610,127671
1002154,452,31062,68611,25282,125407
1002155,80458,53247,49633,89600,272938
1002156,31493,55880,15778,76632,179783
1002157,10215,49959,32101,72849,165124
1002158,92163,33717,28445,16084,170409
1002159,38794,30384,55384,28647,153209
1002160,11483,12041,25453,36325,85302
1002161,62435,51670,54382,28568,197055
1002162,28317,31533,1348,50650,111848
1002163,10705,7495,98560,5876,122636
1002164,43018,23709,21330,70403,158460
1002165,42791,97749,68045,21037,229622
1002166,61589,33782,70301,11706,177378
1002167,93757,86887,75469,70403,326516
1002168,10636,91732,52415,24474,179257
1002169,90736,30888,86533,45806,253963
1002170,53036,18049,52060,90992,214137
1002171,42469,25028,3136,70785,141418
1002172,1975,57282,77129,13201,149587
1002173,26594,50175,65518,54733,197020
1002174,9932,26126,79070,38328,153456
1002175,19630,79050,87290,89516,275486
1002176,94382,86054,81445,61626,323507
1002177,68753,84771,61164,62062,276750
1002178,79787,52446,58684,80468,271385
1002179,15319,46167,59021,18796,139303
1002180,33217,3968,71063,3670,111918
1002181,2552,94676,78332,56903,232463
1002182,67945,59806,5546,19784,153081
1002183,89849,44824,27644,15234,177551
1002184,9774,22345,16223,725,49067
1002185,34211,24945,98981,71936,230073
1002186,27583,70967,34154,27930,160634
1002187,38988,97755,95254,83015,315012
1002188,7456,78024,6174,81819,173473
1002189,33268,87425,21683,56124,198500
1002190,85174,38479,89372,87924,300949
1002191,82107,63367,42021,50366,237861
1002192,54407,88882,80543,73928,297760
1002193,56790,57885,11151,48925,174751
1002194,33222,68109,4626,30594,136551
1002195,48983,28207,58583,81430,217203
1002196,15435,13551,61323,56474,146783
1002197,80225,439,2063,51019,133746
1002198,97019,89563,34345,55416,276343
1002199,28710,88800,81303,58394,257207
1002200,56822,84530,41267,5763,188382
1002201,24553,1812,29204,35829,91398
1002202,53541,39013,35057,12316,139927
1002203,483,40409,38218,36999,116109
1002204,67592,15843,32993,63678,180106
1002205,6590,5287,20942,19721,52540
1002206,17863,50320,6604,87502,162289
1002207,43846,3942,99216,70874,217878
1002208,13113,5502,18300,22928,59843
1002209,84212,64009,24991,71953,245165
1002210,4280,24092,32257,82065,142694
1002211,80320,41834,73846,12055,208055
1002212,28510,17164,79634,62820,188128
1002213,54314,72959,98614,77382,303269
1002214,52659,91051,48408,83392,275510
1002215,13868,692,44812,1689,61061
1002216,71912,69110,39236,83123,263381
1002217,38571,52661,21278,5881,118391
1002218,9539,94975,23569,49165,177248
1002219,28302,60461,64032,94211,247006
1002220,49787,74428,28911,29984,183110
1002221,89868,83744,72645,92697,338954
1002222,14151,88724,35076,81796,219747
1002223,64632,81933,7616,77331,231512
1002224,48170,36125,7305,52425,144025
1002225,38262,32566,87911,73718,232457
1002226,66605,90733,4732,98798,260868
1002227,29301,15198,82956,30045,157500
1002228,42361,11676,67335,80142,201514
1002229,84204,6557,37974,11407,140142
1002230,86180,62951,62588,35321,247040
1002231,48145,97154,83376,59320,287995
1002232,64049,12026,80345,36254,192674
1002233,45663,29032,94959,25571,195225
1002234,34369,52812,19094,64472,170747
1002235,68009,13572,37461,59202,178244
1002236,64345,77689,16564,69041,227639
1002237,91114,31336,65397,93796,281643
1002238,67307,95574,33513,49304,245698
1002239,16479,47336,9180,35886,108881
1002240,22194,79295,46689,56505,204683
1002241,75434,39346,912,25277,140969
1002242,57862,14354,35127,59323,166666
1002243,73724,80697,58943,63367,276731
1002244,54329,19504,36653,7114,117600
1002245,13897,12150,66944,75680,168671
1002246,10826,28522,80774,69390,189512
1002247,15142,74302,87340,65689,242473
1002248,30920,39988,99609,65713,236230
1002249,64530,64387,44126,20811,193854
1002250,1363,86433,3406,8390,99592
1002251,86347,30792,75269,40801,233209
1002252,67328,69760,48681,83381,269150
1002253,89528,6631,47393,85023,228575
1002254,56888,52531,47382,33537,190338
1002255,48095,32374,82103,45876,208448
1002256,57964,12400,488,98696,169548
1002257,5096,96619,84223,94681,280619
1002258,83532,17383,2491,76731,180137
1002259,14963,87712,86489,41336,230500
1002260,18330,43008,41098,74970,177406
1002261,2886,66859,31195,20131,121071
1002262,63415,39241,40303,40825,183784
1002263,35906,4414,44704,50062,135086
1002264,34074,65673,17294,26676,143717
1002265,5041,60141,61264,9269,135715
1002266,86212,62101,2531,91386,242230
1002267,4154,53394,84362,26247,168157
1002268,56645,61581,32865,14707,165798
1002269,58905,52101,40738,26253,177997
1002270,24133,80872,1800,30820,137625
1002271,55310,79043,90151,28186,252690
1002272,77768,12902,22903,60676,174249
1002273,27096,12650,8034,96490,144270
1002274,67177,2878,74322,9272,153649
1002275,63901,42790,44080,11084,161855
1002276,59148,47694,58245,50452,215539
1002277,38009,97546,57289,92607,285451
1002278,15803,32653,7514,39352,95322
1002279,81035,10318,82105,85209,258667
1002280,64334,21104,67954,77463,230855
1002281,51144,88360,74951,45474,259929
1002282,50213,66486,2564,31368,150631
1002283,81799,35623,4839,20331,142592
1002284,49857,39688,97519,54868,241932
1002285,28133,6528,83090,19325,137076
1002286,7538,21529,23884,849,53800
1002287,54147,35662,79078,43976,212863
1002288,25553,74040,26242,50663,176498
1002289,53983,16607,57941,22572,151103
1002290,23120,50898,70563,61764,206345
1002291,37297,4763,60423,88896,191379
1002292,8548,76755,73463,75206,233972
1002293,55896,4434,82254,63123,205707
1002294,5253,95582,51724,20848,173407
1002295,10125,25892,83761,6209,125987
1002296,73801,12429,52289,69711,208230
1002297,64371,91721,57094,98888,312074
1002298,44866,31406,84264,31025,191561
1002299,83739,72333,97842,62152,316066
1002300,52701,53197,7868,82573,196339
1002301,24630,79630,58058,65187,227505
1002302,43646,83967,42848,34899,205360
1002303,86490,78486,75077,43047,283100
1002304,1781,31518,32999,32088,98386
1002305,72065,99266,51215,12141,234687
1002306,84377,92556,51579,2110,230622
1002307,19429,41941,39759,23438,124567
1002308,38546,7478,53689,27778,127491
1002309,60093,47844,73102,39955,220994
1002310,79728,64646,21688,75221,241283
1002311,61266,61861,57487,36991,217605
1002312,38322,5365,39237,34159,117083
1002313,91734,94589,30121,96178,312622
1002314,49470,48650,14102,95044,207266
1002315,81549,17754,54648,38394,192345
1002316,27970,51304,40031,37606,156911
1002317,14281,2525,82602,18384,117792
1002318,50978,59135,48415,13004,171532
1002319,95110,82689,49265,7249,234313
1002320,35389,65434,47301,90777,238901
1002321,98836,51668,12408,81704,244616
1002322,26658,7409,47946,18068,100081
1002323,82777,97231,65187,48935,294130
1002324,29975,47574,32053,65735,175337
1002325,12858,66636,36597,75666,191757
1002326,36791,30971,35078,18239,121079
1002327,92172,32869,96766,20462,242269
1002328,64334,79760,16646,80480,241220
1002329,66405,63539,40326,74708,244978
1002330,45645,83922,52858,37131,219556
1002331,56054,51647,30157,86558,224416
1002332,77994,16216,77288,38555,210053
1002333,28376,82710,59295,22903,193284
1002334,88129,33902,91249,77556,290836
1002335,70337,45018,92631,51671,259657
1002336,83672,11710,70596,66005,231983
1002337,23122,70356,45814,4867,144159
1002338,68849,5518,44636,81581,200584
1002339,80690,36134,36279,37188,190291
1002340,32091,55815,37670,5979,131555
1002341,38185,88496,39339,63478,229498
1002342,89555,947,85043,78,175623
1002343,76480,51925,66727,57834,252966
1002344,63232,12389,26913,1130,103664
1002345,72341,22566,66321,8810,170038
1002346,99247,58084,51742,87258,296331
1002347,8918,97128,45445,81303,232794
1002348,59398,21615,42596,71642,195251
1002349,20105,43681,50485,11829,126100
1002350,81997,79658,88410,95576,345641
1002351,62246,84536,26593,61519,234894
1002352,7353,69089,58690,85680,220812
1002353,54857,73742,83291,81184,293074
1002354,64925,766,68728,82896,217315
1002355,47860,41638,74437,43865,207800
1002356,19928,45811,41189,85317,192245
1002357,29359,58469,9592,48438,145858
1002358,82632,51367,49080,75249,258328
1002359,32441,48948,5101,82989,169479
1002360,48835,27436,66430,10731,153432
1002361,23719,45616,53354,81057,203746
1002362,93714,56599,87051,95160,332524
1002363,59862,34919,70867,55431,221079
1002364,44200,72545,83125,76830,276700
1002365,43993,30374,64539,9501,148407
1002366,78017,27878,29135,60013,195043
1002367,99887,63559,43551,1466,208463
1002368,68751,94935,72203,73951,309840
1002369,43693,90054,1968,94638,230353
1002370,88567,48093,13871,82597,233128
1002371,64710,4873,88293,67263,225139
1002372,4508,21474,8153,96486,130621
1002373,37285,38921,28151,58800,163157
1002374,76407,75414,95149,89376,336346
1002375,46847,94280,34227,68918,244272
1002376,21260,68612,64357,56006,210235
1002377,78789,83496,72871,87551,322707
1002378,88505,25862,6945,40984,162296
1002379,92660,96209,40909,42660,272438
1002380,57373,59571,86018,63577,266539
1002381,36299,70047,87060,56579,249985
1002382,23045,98268,4956,69847,196116
1002383,17446,98908,21009,68094,205457
1002384,52313,84609,4641,28527,170090
1002385,16151,11001,69188,37265,133605
1002386,77427,79508,15941,45020,217896
1002387,40376,25702,98148,9759,173985
1002388,12446,62062,69110,80602,224220
1002389,83416,19511,89471,52117,244515
1002390,86101,49835,87475,98155,321566
1002391,73680,60887,86644,60559,281770
1002392,80986,38292,7585,52196,179059
1002393,47540,39230,60965,33394,181129
1002394,30656,3374,65910,37107,137047
1002395,63198,30979,29967,47598,171742
1002396,21119,12911,70554,78474,183058
1002397,96805,46703,50199,50721,244428
1002398,74901,94449,35404,43524,248278
1002399,54475,11062,38987,33052,137576
1002400,4134,17906,31228,69808,123076
1002401,95301,29984,96747,87148,309180
1002402,77998,87009,93414,40927,299348
1002403,71121,84006,85468,84892,325487
1002404,19384,24620,95127,15600,154731
1002405,44480,53358,2561,36714,137113
1002406,46880,40605,15728,12269,115482
1002407,90998,14629,24848,33555,164030
1002408,2305,27857,6797,68518,105477
1002409,19616,90894,17752,95746,224008
1002410,22932,49787,90742,79116,242577
1002411,72096,82588,31289,90865,276838
1002412,58214,33920,92155,54020,238309
1002413,81938,45026,20282,39746,186992
1002414,45410,98617,51639,94697,290363
1002415,56669,64857,10806,86800,219132
1002416,32307,28262,67462,54164,182195
1002417,15737,6374,18977,88442,129530
1002418,76376,66319,99754,73610,316059
1002419,21880,96680,21889,20398,160847
1002420,64066,72120,20510,86229,242925
1002421,73459,11630,87233,42370,214692
1002422,99267,60764,9105,77198,246334
1002423,11733,87379,8853,79793,187758
1002424,75475,55716,72808,29683,233682
1002425,12709,49489,90213,18121,170532
1002426,23707,4144,11072,29668,68591
1002427,14341,20674,51347,81800,168162
1002428,7220,59825,34733,9765,111543
1002429,21420,136,9867,21960,53383
1002430,39416,39211,82057,13524,174208
1002431,33379,31285,22757,27963,115384
1002432,9666,62693,57603,22992,152954
1002433,91326,4467,55214,64621,215628
1002434,41106,32375,28725,59251,161457
1002435,87952,3197,11789,21725,124663
1002436,10042,73157,53123,55874,192196
1002437,97358,79192,92120,74444,343114
1002438,91606,32279,45231,3231,172347
1002439,40294,70138,55972,95016,261420
1002440,233,27761,72884,49303,150181
1002441,75114,70035,22660,44022,211831
1002442,60280,12911,30080,18889,122160
1002443,35764,7036,71102,31348,145250
1002444,57181,85838,78633,99732,321384
1002445,8154,54508,73919,97732,234313
1002446,4692,98145,36801,18782,158420
1002447,61659,18890,97204,40607,218360
1002448,52356,68351,84994,70990,276691
1002449,93275,16096,61500,54687,225558
1002450,78625,56746,50787,35668,221826
1002451,99674,91479,69603,73901,334657
1002452,99576,91325,82528,83852,357281
1002453,75393,85729,53485,40306,254913
1002454,87701,37351,66066,270,191388
1002455,61464,17049,58679,94533,231725
1002456,69385,97746,94164,30679,291974
1002457,55558,19962,35258,25881,136659
1002458,68235,61432,23455,35380,188502
1002459,43534,45889,23071,87764,200258
1002460,90561,20868,61446,42147,215022
1002461,55413,90244,13762,9609,169028
1002462,21594,4551,55506,25379,107030
1002463,32918,15723,71407,37288,157336
1002464,98249,58850,97893,21099,276091
1002465,8740,4607,77444,15862,106653
1002466,65625,73265,54846,24368,218104
1002467,2450,36482,31040,72105,142077
1002468,42560,14880,68205,93436,219081
1002469,31988,90219,90637,98466,311310
1002470,7084,40959,70841,35493,154377
1002471,14517,28391,38942,11287,93137
1002472,75121,49157,46967,55716,226961
1002473,63769,1135,71011,10703,146618
1002474,17531,22174,48741,88945,177391
1002475,72803,21834,31620,77753,204010
1002476,77197,83759,14868,12761,188585
1002477,61285,16617,79917,41599,199418
1002478,6826,5614,51776,7353,71569
1002479,80888,5383,22984,88669,197924
1002480,56963,39801,77741,12931,187436
1002481,30754,63700,83494,59613,237561
1002482,88161,9355,56055,76909,230480
1002483,70416,49899,29756,31676,181747
1002484,86118,90145,78571,99498,354332
1002485,31987,40327,56933,18447,147694
1002486,52978,88442,5221,925,147566
1002487,27866,25982,99649,89335,242832
1002488,29523,9474,79805,11504,130306
1002489,28528,42647,8751,12187,92113
1002490,36245,65849,35659,24747,162500
1002491,16427,87917,74958,78665,257967
1002492,97473,66491,77874,11365,253203
1002493,39940,50636,94778,9134,194488
1002494,68016,74553,37629,65386,245584
1002495,82831,89450,84863,60899,318043
1002496,16205,18202,39016,164,73587
1002497,43989,51559,46911,27223,169682
1002498,88242,25282,72792,28024,214340
1002499,45113,84619,79371,45885,254988
1002500,57975,29251,96527,99120,282873
1002501,97791,93103,13718,91352,295964
1002502,48588,83177,37736,64177,233678
1002503,81545,78859,16836,25713,202953
1002504,53100,37811,31294,27287,149492
1002505,89166,4620,53265,43784,190835
1002506,13458,76435,9788,13970,113651
1002507,70574,67242,37781,91769,267366
1002508,66533,19520,77458,14690,178201
1002509,33634,48624,24369,9286,115913
1002510,99512,71961,99275,84747,355495
1002511,95621,17407,2295,59512,174835
1002512,33887,79119,28144,17016,158166
1002513,74443,49369,26175,21198,171185
1002514,77122,75691,27044,33805,213662
1002515,55998,22568,59918,48996,187480
1002516,21708,46702,31156,64514,164080
1002517,57609,59557,88821,43781,249768
1002518,41695,2289,7817,9918,61719
1002519,55277,81070,66893,34948,238188
1002520,6981,35683,61805,20261,124730
1002521,60057,1842,72486,84742,219127
1002522,16978,37534,36279,72317,163108
1002523,91456,43589,17438,87232,239715
1002524,2339,75442,40466,57627,175874
1002525,4557,99275,82261,68697,254790
1002526,80362,82930,90541,5541,259374
1002527,4242,64839,4383,71064,144528
1002528,35383,87741,65639,38353,227116
1002529,55986,38696,64070,65639,224391
1002530,94563,49692,58112,26889,229256
1002531,6510,46965,81991,29596,165062
1002532,59782,8739,37863,1695,108079
1002533,46116,45013,59347,35295,185771
1002534,10952,51953,88257,1533,152695
1002535,85828,30336,91301,42272,249737
1002536,56755,20924,30529,41079,149287
1002537,62425,17969,91470,80032,251896
1002538,31292,26272,23092,81684,162340
1002539,31055,20610,23261,83366,158292
1002540,27735,39230,43216,38919,149100
1002541,80377,37386,41376,25722,184861
1002542,18335,65249,65642,97618,246844
1002543,66233,7113,54796,59050,187192
1002544,20729,94365,43104,10398,168596
1002545,45009,64456,78385,22988,210838
1002546,82561,9962,65896,75138,233557
1002547,50690,70552,77423,76192,274857
1002548,97375,92389,74970,40062,304796
1002549,44274,832,42259,42906,130271
1002550,14899,66038,61271,37687,179895
1002551,59112,94700,43456,72912,270180
1002552,23162,24294,8521,22507,78484
1002553,19497,22785,31768,28557,102607
1002554,19750,97182,37387,32681,187000
1002555,48969,61991,66470,36134,213564
1002556,63901,19712,12577,49693,145883
1002557,73732,90529,98112,31134,293507
1002558,7576,86761,94791,43636,232764
1002559,77266,13063,19010,1076,110415
1002560,27688,67309,80066,57278,232341
1002561,40087,5134,86456,90226,221903
1002562,73175,15438,72246,3875,164734
1002563,1756,92332,76037,24557,194682
1002564,47379,42380,40165,82059,211983
1002565,11493,22181,13014,74937,121625
1002566,52931,6661,4698,38133,102423
1002567,59295,60685,70216,93459,283655
1002568,87212,9330,42952,40751,180245
1002569,91396,99152,58830,34261,283639
1002570,5031,85478,27698,29103,147310
1002571,39662,99657,89432,14406,243157
1002572,24650,25465,14369,70912,135396
1002573,59203,82083,50135,73889,265310
1002574,6165,19445,43889,21780,91279
1002575,61722,75744,61672,13687,212825
1002576,6646,36260,71542,86327,200775
1002577,33955,15555,32418,33739,115667
1002578,34647,20724,46882,60332,162585
1002579,72789,28243,51525,13540,166097
1002580,97006,73528,32158,44110,246802
1002581,14438,79761,43939,96938,235076
1002582,70456,4080,80478,85695,240709
1002583,58341,79594,97567,78182,313684
1002584,9056,66484,10613,39484,125637
1002585,21271,90021,91126,86060,288478
1002586,10413,5314,91287,30339,137353
1002587,20332,53036,54993,53618,181979
1002588,95632,27456,98637,91475,313200
1002589,73504,64954,83621,32805,254884
1002590,16876,93078,6331,9443,125728
1002591,62075,36111,88864,73847,260897
1002592,52028,42446,75060,88475,258009
1002593,91140,15656,22294,1115,130205
1002594,87301,77961,71476,48777,285515
1002595,99376,35352,64545,91212,290485
1002596,33714,62373,14914,96028,207029
1002597,32163,27953,88794,2318,151228
1002598,91368,80239,93254,86131,350992
1002599,13637,49243,18713,8873,90466
1002600,10691,69823,17794,55511,153819
1002601,55236,11134,30234,32391,128995
1002602,18347,26508,44434,27631,116920
1002603,64985,58795,30925,44362,199067
1002604,64330,33316,97624,11617,206887
1002605,72739,39086,32667,22861,167353
1002606,72456,52312,21614,10506,156888
1002607,3393,87894,78878,86604,256769
1002608,59071,76637,62348,38227,236283
1002609,30926,95119,31680,88258,245983
1002610,54238,11001,78225,7252,150716
1002611,85296,70548,77761,27627,261232
1002612,47428,15074,33287,61242,157031
1002613,84142,49463,88127,45834,267566
1002614,4205,95478,27095,94707,221485
1002615,45625,98315,96044,33791,273775
1002616,2213,91496,69406,41089,204204
1002617,271,26406,24188,33381,84246
1002618,51520,96528,2022,59744,209814
1002619,51290,59709,14346,131,125476
1002620,9508,75035,74209,61750,220502
1002621,84555,34669,2498,48797,170519
1002622,87108,34100,44908,57785,223901
1002623,64201,67772,90332,16309,238614
1002624,31631,21843,37981,54576,146031
1002625,10099,78974,60022,26168,175263
1002626,18187,50235,94681,17650,180753
1002627,62648,15045,54935,30416,163044
1002628,28101,68005,65097,53136,214339
1002629,83046,27436,4822,784,116088
1002630,54411,72266,11785,39354,177816
1002631,99025,84955,99562,60792,344334
1002632,24861,55492,88242,15530,184125
1002633,97858,26300,48999,83859,257016
1002634,50110,56538,56148,3745,166541
1002635,66668,55558,42758,94041,259025
1002636,66603,72865,84319,96460,320247
1002637,93839,13394,55413,44869,207515
1002638,83062,69395,6661,68020,227138
1002639,53540,7197,91782,12837,165356
1002640,45871,60753,97698,25584,229906
1002641,37092,39566,77967,39652,194277
1002642,76379,92037,70011,93920,332347
1002643,5742,42225,22307,52918,123192
1002644,99022,70134,21738,10607,201501
1002645,20955,25830,22562,22193,91540
1002646,998,17144,72276,54637,145055
1002647,1600,80221,16364,37201,135386
1002648,39292,32713,26712,95425,194142
1002649,27061,75338,50024,34568,186991
1002650,69607,12999,33788,63347,179741
1002651,75923,91689,86184,19750,273546
1002652,79868,63410,58315,87113,288706
1002653,662,77124,88730,97861,264377
1002654,3773,93956,88126,40342,226197
1002655,61290,60360,52530,13762,187942
1002656,20521,44923,47362,92861,205667
1002657,61908,85956,89895,49488,287247
1002658,88408,92174,84260,95995,360837
1002659,34093,44458,66659,43436,188646
1002660,1079,13239,17334,59527,91179
1002661,89462,29352,97863,14696,231373
1002662,54615,63091,43852,19351,180909
1002663,68378,68877,45118,18647,201020
1002664,80081,16697,26648,43549,166975
1002665,22272,89090,25997,97095,234454
1002666,82559,46294,30238,14917,174008
1002667,63992,83518,72434,10058,230002
1002668,54182,21301,20589,34432,130504
1002669,90705,87548,59611,93913,331777
1002670,48566,4867,65932,77650,197015
1002671,98716,1718,90479,16967,207880
1002672,6735,51545,52884,93484,204648
1002673,22862,17697,52471,3192,96222
1002674,65581,61857,73564,51129,252131
1002675,27685,88563,23184,22728,162160
1002676,81125,33331,50999,77096,242551
1002677,12437,85779,30031,23565,151812
1002678,43748,38610,22506,80257,185121
1002679,24702,40100,76069,84561,225432
1002680,73557,78546,17461,90510,260074
1002681,8748,2239,96473,16807,124267
1002682,68401,3681,28533,52140,152755
1002683,81942,85698,9426,56632,233698
1002684,32386,56988,74219,56996,220589
1002685,86971,9759,81266,92599,270595
1002686,5,2787,78660,90575,172027
1002687,81283,98846,73729,37339,291197
1002688,36164,59842,64864,17446,178316
1002689,68297,62459,86608,56914,274278
1002690,54350,35702,21824,7660,119536
1002691,35317,65288,50942,24073,175620
1002692,20708,21193,76530,60653,179084
1002693,70598,40768,77674,39831,228871
1002694,67389,18014,79577,92036,257016
1002695,31455,76823,60794,87262,256334
1002696,77938,22767,36605,61983,199293
1002697,69807,17819,57920,91656,237202
1002698,43330,75490,68927,44961,232708
1002699,65967,37376,45092,16861,165296
1002700,62462,52999,87910,88693,292064
1002701,19606,1045,33260,23085,76996
1002702,16222,51405,27186,53218,148031
1002703,1256,60367,57377,98685,217685
1002704,90647,668,10515,5639,107469
1002705,48265,68276,53314,94186,264041
1002706,7526,13861,38398,44842,104627
1002707,52249,26397,21407,20302,120355
1002708,26523,78954,67781,53834,227092
1002709,1546,13886,29541,73134,118107
1002710,49532,54185,61513,79631,244861
1002711,1459,64746,16745,24521,107471
1002712,93790,57735,77281,38995,267801
1002713,96184,54883,55558,33628,240253
1002714,4426,41915,70890,23452,140683
1002715,39753,92300,84898,77203,294154
1002716,89475,34758,74559,16690,215482
1002717,6971,70959,12208,53334,143472
1002718,60337,51638,22356,42625,176956
1002719,91143,1570,28484,97538,218735
1002720,53046,54775,62927,87890,258638
1002721,79106,10132,44197,37672,171107
1002722,33440,88545,34416,94445,250846
1002723,65219,29392,81827,29339,205777
1002724,32498,6606,839,98721,138664
1002725,37915,39960,54569,67199,199643
1002726,44224,99813,58933,5987,208957
1002727,21559,89307,44471,15427,170764
1002728,96363,5664,10645,44488,157160
1002729,97622,61820,55015,72915,287372
1002730,76058,37892,25055,70299,209304
1002731,63574,42244,42757,12246,160821
1002732,10856,29511,42677,24719,107763
1002733,76122,90710,59696,53507,280035
1002734,57486,97796,54022,56405,265709
1002735,64531,34391,34542,25946,159410
1002736,40749,78165,65889,65096,249899
1002737,11813,77532,98780,74081,262206
1002738,63583,57744,24567,46291,192185
1002739,15936,54821,24742,78384,173883
1002740,53486,27085,12555,90268,183394
1002741,20590,40936,41985,81795,185306
1002742,41098,9883,13066,8997,73044
1002743,68033,40632,39839,36910,185414
1002744,98931,45637,54244,40864,239676
1002745,88247,25676,31557,16323,161803
1002746,71827,78825,49066,68185,267903
1002747,99681,5219,19472,25477,149849
1002748,87896,66533,65850,66227,286506
1002749,98562,97572,40701,94673,331508
1002750,75544,11442,6373,48700,142059
1002751,63138,54102,92832,65020,275092
1002752,6848,3381,67893,77272,155394
1002753,73943,94436,37343,50071,255793
1002754,92856,18481,13691,49936,174964
1002755,23075,41432,27606,81355,173468
1002756,88783,85973,87986,21068,283810
1002757,10659,1148,3945,62066,77818
1002758,52956,60553,80107,59060,252676
1002759,28737,7573,71405,71448,179163
1002760,95194,60754,92355,7902,256205
1002761,1876,31135,98608,88648,220267
1002762,62229,79778,1542,25906,169455
1002763,42233,70755,92406,97597,302991
1002764,20352,57176,66112,30185,173825
1002765,52153,81156,78032,62603,273944
1002766,80359,51199,78850,91512,301920
1002767,54853,97224,35744,62337,250158
1002768,59379,34494,18743,96277,208893
1002769,53763,51481,17247,6313,128804
1002770,18989,24188,38327,93863,175367
1002771,81638,81709,61888,91876,317111
1002772,4174,99208,16013,21297,140692
1002773,54353,16568,18439,75432,164792
1002774,268,64922,28226,98170,191586
1002775,38621,78530,62074,66733,245958
1002776,93664,74185,47413,88224,303486
1002777,18317,1836,33956,75633,129742
1002778,22788,5049,44384,7025,79246
1002779,68779,70555,28678,70102,238114
1002780,89419,43324,24584,41104,198431
1002781,89437,28772,40349,12495,171053
1002782,53593,62385,50752,76936,243666
1002783,47300,80035,90761,12985,231081
1002784,67181,3738,78485,890,150294
1002785,79695,30899,46650,98375,255619
1002786,83422,96640,73862,3478,257402
1002787,49680,11254,57721,70021,188676
1002788,23482,42463,52383,94920,213248
1002789,27788,19826,94642,44714,186970
1002790,89002,89262,90108,59002,327374
1002791,57148,62898,39158,25241,184445
1002792,67684,72509,70810,95109,306112
1002793,76331,14469,66444,12133,169377
1002794,74735,72936,59263,88405,295339
1002795,93485,20224,93934,89754,297397
1002796,94728,71427,23386,21349,210890
1002797,33667,55209,99169,49967,238012
1002798,47077,90888,18576,88730,245271
1002799,22748,70126,77115,39624,209613
1002800,17787,54206,11524,6819,90336
1002801,88734,27309,80074,79113,275230
1002802,79181,85427,24342,62787,251737
1002803,74969,35930,78116,54260,243275
1002804,43088,65539,72486,90172,271285
1002805,11035,26957,31213,61339,130544
1002806,63168,19433,29412,34772,146785
1002807,68734,84646,41236,10436,205052
1002808,24127,81162,29133,76210,210632
1002809,14537,31598,9938,82642,138715
1002810,56241,47337,31418,49623,184619
1002811,84231,83864,77610,85645,331350
1002812,52365,61612,7877,43754,165608
1002813,52865,94902,3870,77756,229393
1002814,91278,7421,74124,64029,236852
1002815,20905,37874,49358,10790,118927
1002816,88035,66120,84179,40758,279092
1002817,16432,33235,27145,8331,85143
1002818,55546,53048,76232,9900,194726
1002819,82109,35057,23861,64552,205579
1002820,69966,93766,43945,82298,289975
1002821,15784,88939,75781,60899,241403
1002822,34655,16907,34173,96154,181889
1002823,22626,78295,91197,22025,214143
1002824,34756,3386,50676,67117,155935
1002825,92029,13025,89793,10411,205258
1002826,88277,29666,88377,41561,247881
1002827,35128,30839,91527,38080,195574
1002828,29146,18049,34865,58540,140600
1002829,14562,64062,8829,1000,88453
1002830,16401,22511,13200,8763,60875
1002831,58961,72820,4682,71485,207948
1002832,83250,58142,7392,18129,166913
1002833,36857,38447,37273,7357,119934
1002834,71989,58251,70266,10371,210877
1002835,77179,98443,66813,39842,282277
1002836,4019,10684,49760,12475,76938
1002837,14045,34183,46225,99911,194364
1002838,2743,4280,2957,90911,100891
1002839,4789,61916,6224,55979,128908
1002840,27690,3974,2683,6252,40599
1002841,43633,47819,78187,36897,206536
1002842,12243,29103,38280,86079,165705
1002843,81732,73163,90384,22260,267539
1002844,27223,37935,28693,4138,97989
1002845,44986,35460,37477,64159,182082
1002846,89289,98734,56397,44704,289124
1002847,75959,15953,86989,55574,234475
1002848,41647,40546,90641,67228,240062
1002849,85510,52555,71552,10007,219624
1002850,42207,99081,94599,24024,259911
1002851,85471,47720,40736,89305,263232
1002852,47644,93633,55534,55282,252093
1002853,86076,43826,58180,61653,249735
1002854,21547,20577,31325,97026,170475
1002855,52116,95215,88507,4373,240211
1002856,42120,32966,80686,9110,164882
1002857,47180,61693,57956,32126,198955
1002858,16515,47078,84907,31712,180212
1002859,52885,68217,93561,253,214916
1002860,88906,29119,40805,18255,177085
1002861,96053,13868,62458,95086,267465
1002862,24836,87008,56195,60435,228474
1002863,15855,71761,52066,98951,238633
1002864,22308,15326,44995,56052,138681
1002865,92656,66485,13585,79825,252551
1002866,74015,80224,89454,36841,280534
1002867,75041,65375,12088,9628,162132
1002868,40213,24196,54274,14284,132967
1002869,97304,32686,97521,86673,314184
1002870,74354,70014,23873,17901,186142
1002871,34839,2137,37975,38513,113464
1002872,85472,4245,6181,60897,156795
1002873,16326,79658,95489,63447,254920
1002874,12752,28541,27841,73259,142393
1002875,58404,54009,69582,33688,215683
1002876,70285,51141,26003,17965,165394
1002877,5009,71678,49168,55322,181177
1002878,93580,99647,1495,78320,273042
1002879,57074,11535,97541,79233,245383
1002880,81453,80859,8947,8028,179287
1002881,5147,52787,6063,48177,112174
1002882,84945,55513,93784,96536,330778
1002883,34268,8125,43160,1124,86677
1002884,51236,50696,27153,44498,173583
1002885,66095,78468,62642,24764,231969
1002886,9329,1125,21263,51560,83277
1002887,55943,78435,14460,8486,157324
1002888,88316,74681,99085,91057,353139
1002889,59460,88884,72260,81938,302542
1002890,12651,77590,72941,6976,170158
1002891,67993,2505,12764,58682,141944
1002892,94912,41738,25318,14914,176882
1002893,69197,2844,5085,88303,165429
1002894,8134,33449,99635,12706,153924
1002895,7940,1697,2183,38026,49846
1002896,61750,70367,9800,74362,216279
1002897,52236,51616,60073,88825,252750
1002898,87703,25501,76194,86680,276078
1002899,17772,32908,78387,71137,200204
1002900,57045,32538,10514,65205,165302
1002901,34160,7951,99767,29845,171723
1002902,23098,35459,64139,78457,201153
1002903,56237,59856,69100,59905,245098
1002904,74054,54497,52416,34803,215770
1002905,66020,15944,9121,63041,154126
1002906,10947,68807,80443,74762,234959
1002907,4735,39151,21813,4216,69915
1002908,48010,44560,56656,93606,242832
1002909,51500,79977,89589,14477,235543
1002910,78843,95690,26518,90609,291660
1002911,81380,42771,71361,13415,208927
1002912,16273,36348,15302,53804,121727
1002913,46620,75126,74142,89472,285360
1002914,95835,30084,83616,37390,246925
1002915,97239,1285,77666,70680,246870
1002916,66404,29547,71139,22342,189432
1002917,90075,69849,38029,42919,240872
1002918,95944,61162,14771,304,172181
1002919,59309,95588,30211,70099,255207
1002920,82391,8662,96453,64785,252291
1002921,92792,2814,84799,27084,207489
1002922,69210,48145,20814,57034,195203
1002923,99811,87398,1824,20167,209200
1002924,16459,67012,84083,35967,203521
1002925,25720,2056,48940,16146,92862
1002926,25759,12581,28718,58474,125532
1002927,53334,80977,54544,35727,224582
1002928,67789,75946,61865,94666,300266
1002929,25155,50203,2461,9630,87449
1002930,55804,85844,35377,95046,272071
1002931,10669,87329,92106,70890,260994
1002932,38630,21116,49991,30278,140015
1002933,9354,82408,94820,51787,238369
1002934,78454,80162,25572,85278,269466
1002935,53412,29280,14701,99198,196591
1002936,38681,89999,84558,19495,232733
1002937,64997,22928,45254,37656,170835
1002938,27071,58884,72736,21926,180617
1002939,84686,9852,13025,99472,207035
1002940,32375,85716,3480,57267,178838
1002941,18269,35932,65131,28695,148027
1002942,65476,50138,99549,46055,261218
1002943,5514,41859,51586,33602,132561
1002944,31326,93638,7631,88407,221002
1002945,6416,35825,53635,76999,172875
1002946,31226,12188,12353,80887,136654
1002947,7043,59510,93527,56259,216339
1002948,78588,93267,50741,13754,236350
1002949,37556,26930,2710,39537,106733
1002950,11716,20069,98335,13647,143767
1002951,37871,10050,15980,63848,127749
1002952,7348,58507,41458,26906,134219
1002953,87153,33502,32210,28005,180870
1002954,19047,55664,40522,78460,193693
1002955,75423,59222,94720,92288,321653
1002956,85562,9973,35565,24759,155859
1002957,73376,11456,41007,90400,216239
1002958,19916,95922,5668,1445,122951
1002959,3271,89280,57199,65605,215355
1002960,70254,70315,11502,60338,212409
1002961,40372,82456,26054,19399,168281
1002962,82097,6511,56291,54736,199635
1002963,35538,77147,9010,83607,205302
1002964,7518,68179,73578,22918,172193
1002965,12343,81832,88019,86046,268240
1002966,3808,14811,85989,79335,183943
1002967,66395,34027,63533,54739,218694
1002968,11061,83433,98105,59399,251998
1002969,42198,94050,44807,60233,241288
1002970,17251,80237,77729,33512,208729
1002971,49764,62434,73780,30609,216587
1002972,61003,96326,891,65253,223473
1002973,46887,11243,60258,59895,178283
1002974,17540,44893,69245,40933,172611
1002975,20354,67913,83543,85945,257755
1002976,33918,17646,84455,8697,144716
1002977,72887,9982,80177,51014,214060
1002978,11563,47422,93456,45889,198330
1002979,54385,81100,66229,52294,254008
1002980,26431,63266,75370,24977,190044
1002981,93377,5196,88329,18832,205734
1002982,18112,10310,73565,30774,132761
1002983,1150,26344,89020,75399,191913
1002984,41235,3619,39951,80418,165223
1002985,43536,47386,16179,62381,169482
1002986,54032,61369,9905,98754,224060
1002987,5935,66612,98916,98778,270241
1002988,65581,3267,69934,15687,154469
1002989,88025,91820,62226,77649,319720
1002990,61976,44636,29517,92897,229026
1002991,17909,12246,55386,73248,158789
1002992,64856,99545,35110,42287,241798
1002993,20874,49512,66309,21011,157706
1002994,69806,71441,79418,31987,252652
1002995,68956,72055,26166,18506,185683
1002996,19724,57581,82215,58702,218222
1002997,87810,47464,1296,39253,175823
1002998,6376,55629,42393,97766,202164
1002999,58041,86455,9930,8281,162707
1003000,23107,67993,98745,26008,215853
1003001,93571,20561,89085,87412,290629
1003002,42692,96296,57071,50045,246104
1003003,54029,30531,85707,70414,240681
1003004,21271,28657,80333,17866,148127
1003005,30559,11776,97236,68706,208277
1003006,15116,45365,84782,64699,209962
1003007,29912,56639,84308,28761,199620
1003008,90960,92335,72981,62096,318372
1003009,56746,60770,29725,26954,174195
1003010,70339,91615,46034,85815,293803
1003011,79523,97276,76794,2703,256296
1003012,71400,64930,95923,12503,244756
1003013,35868,83463,34339,2168,155838
1003014,12723,76157,70689,73147,232716
1003015,48466,25832,8205,45033,127536
1003016,90693,87159,60909,37080,275841
1003017,85054,7418,11034,43818,147324
1003018,1547,24774,1473,93791,121585
1003019,1286,33384,81372,22509,138551
1003020,23178,89301,28276,4596,145351
1003021,40658,73837,1324,21060,136879
1003022,4430,58036,48692,35934,147092
1003023,82734,53932,62723,13400,212789
1003024,53205,94631,7004,75311,230151
1003025,62253,32517,95664,94699,285133
1003026,56540,86933,5454,55748,204675
1003027,61500,55264,7182,12927,136873
1003028,30097,62930,70971,30922,194920
1003029,27704,3556,253,47421,78934
1003030,79618,976,51431,75407,207432
1003031,43563,74457,21205,87720,226945
1003032,15873,63925,45689,93534,219021
1003033,902,49040,78955,15066,143963
1003034,14836,76521,51564,32387,175308
1003035,15617,24767,92988,22715,156087
1003036,23196,91204,45377,63690,223467
1003037,73607,36818,17810,63575,191810
1003038,4961,28305,88068,35501,156835
1003039,94631,12441,43436,6370,156878
1003040,35192,81482,57108,15007,188789
1003041,63634,97806,60031,13483,234954
1003042,53191,43519,24304,91232,212246
1003043,81861,52149,61850,64247,260107
1003044,38604,26903,61436,98418,225361
1003045,90490,81328,9913,52969,234700
1003046,53815,85800,11289,3442,154346
1003047,92193,8670,76902,10215,187980
1003048,37911,49865,45392,33186,166354
1003049,62054,87849,64683,60255,274841
1003050,77882,68751,73662,2842,223137
1003051,60456,72135,66389,1729,200709
1003052,46329,76237,62541,41597,226704
1003053,23533,50355,7525,6305,87718
1003054,44903,54497,97216,15747,212363
1003055,67851,37857,14261,36806,156775
1003056,3296,26240,62283,98553,190372
1003057,88769,26588,75256,76060,266673
1003058,6241,67333,93276,73183,240033
1003059,10917,61728,60640,21066,154351
1003060,79067,7733,33761,41601,162162
1003061,21423,10338,22405,68150,122316
1003062,93620,87180,8139,59024,247963
1003063,96962,36542,82025,7132,222661
1003064,63039,97466,94814,99643,354962
1003065,80277,17496,8262,45498,151533
1003066,48696,63407,28981,28478,169562
1003067,175,52624,55416,94201,202416
1003068,23940,45302,3625,72988,145855
1003069,60923,13418,11210,65927,151478
1003070,33857,32933,81808,63419,212017
1003071,61819,90426,6890,81171,240306
1003072,35467,52165,16392,27347,131371
1003073,59840,64186,93182,83375,300583
1003074,277,18615,97599,26359,142850
1003075,11105,73299,33736,39191,157331
1003076,87338,7408,80588,50718,226052
1003077,89820,15607,13803,54450,173680
1003078,68104,15616,67247,77695,228662
1003079,53667,24333,61862,41228,181090
1003080,5633,61968,29225,46536,143362
1003081,50216,43897,54651,39587,188351
1003082,85918,31141,20201,18601,155861
1003083,94546,39400,9787,67933,211666
1003084,37300,92250,20102,10167,159819
1003085,15687,15718,49358,51617,132380
1003086,98171,21258,60953,35991,216373
1003087,84237,75435,79684,5100,244456
1003088,7553,34982,18016,28277,88828
1003089,51284,68011,59343,91620,270258
1003090,55851,39002,7677,2078,104608
1003091,1005,57013,56729,38298,153045
1003092,8055,67191,79494,27379,182119
1003093,14977,10132,38751,67261,131121
1003094,894,29788,24475,83265,138422
1003095,70244,86141,7859,67456,231700
1003096,41315,97365,3616,2081,144377
1003097,93433,87624,8481,48436,237974
1003098,87729,39556,25000,15276,167561
1003099,50534,24453,55956,8985,139928
1003100,44922,19346,29994,71620,165882
1003101,98911,60326,78741,35528,273506
1003102,94591,4460,24060,30138,153249
1003103,68009,36618,45872,50104,200603
1003104,48648,74473,99901,34946,257968
1003105,94394,11168,10131,35822,151515
1003106,62015,81295,28007,68135,239452
1003107,58954,5421,27941,73305,165621
1003108,64494,57588,51889,76777,250748
1003109,22480,20515,70548,67470,181013
1003110,5736,75300,4542,69929,155507
1003111,23026,84844,48724,7521,164115
1003112,898,68544,49264,6929,125635
1003113,23337,96753,66154,93162,279406
1003114,73043,75589,74091,3925,226648
1003115,6503,7531,43894,1409,59337
1003116,2128,22504,87454,12192,124278
1003117,83732,94653,10560,55786,244731
1003118,24212,57276,30951,88897,201336
1003119,20628,88182,58986,22931,190727
1003120,74365,74089,59932,11293,219679
1003121,76243,23555,61185,43975,204958
1003122,70231,72215,51686,9318,203450
1003123,28968,53856,87806,27700,198330
1003124,36813,23109,25320,60126,145368
1003125,45794,32724,69914,48073,196505
1003126,95670,15750,8281,60146,179847
1003127,79085,96465,96904,13970,286424
1003128,12090,74897,73785,75192,235964
1003129,45075,62648,82776,31234,221733
1003130,1887,19920,19517,7202,48526
1003131,71134,14732,94074,52149,232089
1003132,26979,77824,86499,59278,250580
1003133,32071,39246,58714,96562,226593
1003134,71172,75828,19289,52555,218844
1003135,22951,29010,82420,12626,147007
1003136,29005,57874,20115,29645,136639
1003137,76214,39317,42185,93136,250852
1003138,17145,32372,94980,93752,238249
1003139,93801,37229,43516,56883,231429
1003140,93864,84212,88291,94683,361050
1003141,31049,45470,67841,32057,176417
1003142,43293,11013,70934,98228,223468
1003143,65275,51829,11405,59921,188430
1003144,51577,24926,47417,29584,153504
1003145,53569,62646,89134,35355,240704
1003146,51846,66600,15871,94415,228732
1003147,4351,37668,95384,55345,192748
1003148,94568,59405,92457,72415,318845
1003149,11077,19127,73528,6872,110604
1003150,16048,37839,51426,87892,193205
1003151,28525,2108,12710,79836,123179
1003152,44912,62891,94147,80576,282526
1003153,17957,55732,29860,24097,127646
1003154,53768,91992,37337,82677,265774
1003155,49544,14299,99513,83359,246715
1003156,33880,69500,43945,21827,169152
1003157,27551,84242,38944,80936,231673
1003158,84496,99635,77332,91453,352916
1003159,42378,59048,68023,73468,242917
1003160,99722,13390,64952,22276,200340
1003161,95090,54247,38561,44158,232056
1003162,13524,22716,55153,27304,118697
1003163,37417,54128,46423,40473,178441
1003164,2927,93329,43694,83226,223176
1003165,85983,18844,76958,20707,202492
1003166,9340,65680,50343,71797,197160
1003167,96260,58541,76543,8982,240326
1003168,96436,72525,54278,76184,299423
1003169,51100,86042,11022,44671,192835
1003170,98989,48210,64845,56712,268756
1003171,89943,35805,65925,5789,197462
1003172,59418,5835,76373,96122,237748
1003173,79026,22284,72721,22051,196082
1003174,94833,9095,44168,19515,167611
1003175,43064,58539,22369,75788,199760
1003176,35112,86085,74159,26461,221817
1003177,55121,33027,31322,67244,186714
1003178,6308,10353,69274,85836,171771
1003179,21537,25574,85665,36372,169148
1003180,66805,4002,51721,91029,213557
1003181,32487,50244,7849,94613,185193
1003182,9565,47145,74464,88108,219282
1003183,6960,32717,41141,30140,110958
1003184,572,51548,32604,14884,99608
1003185,17254,40581,5444,21035,84314
1003186,43845,96114,43487,1317,184763
1003187,26836,27464,58853,71626,184779
1003188,51711,95400,84706,94557,326374
1003189,19557,38198,99153,28983,185891
1003190,23054,17332,11818,54802,107006
1003191,94509,15111,20957,11483,142060
1003192,18000,52581,26115,20662,117358
1003193,50103,9455,32631,75922,168111
1003194,7242,16374,83298,6838,113752
1003195,41704,15686,20931,71785,150106
1003196,77131,65839,59131,29416,231517
1003197,66633,24537,97320,83809,272299
1003198,27327,39559,62657,66485,196028
1003199,76638,30845,8530,22438,138451
1003200,79447,58057,20235,20467,178206
1003201,47596,48438,98024,59518,253576
1003202,2626,9836,50437,9523,72422
1003203,69436,49621,6703,80930,206690
1003204,99478,78322,33432,87912,299144
1003205,47439,54605,76820,20258,199122
1003206,28988,67806,40480,75124,212398
1003207,84269,9090,44898,26428,164685
1003208,6913,67223,44693,6865,125694
1003209,22124,19969,17962,53883,113938
1003210,66312,9318,34722,6196,116548
1003211,10152,37798,16922,86553,151425
1003212,47742,63440,44421,1236,156839
1003213,21417,43013,57164,29482,151076
1003214,29903,11554,85550,48460,175467
1003215,99941,5717,3873,82620,192151
1003216,67295,40469,54929,11876,174569
1003217,79430,14765,57556,97817,249568
1003218,82877,50040,93854,94410,321181
1003219,34000,8993,7733,17909,68635
1003220,93084,39918,44609,37270,214881
1003221,94008,69991,5927,72161,242087
1003222,14086,66469,96460,60740,237755
1003223,40408,42728,91186,97698,272020
1003224,26257,46879,16165,23084,112385
1003225,28767,49806,75362,5624,159559
1003226,92664,23858,6159,53218,175899
1003227,29732,49104,33651,8119,120606
1003228,39866,68658,2646,71177,182347
1003229,27212,24364,15582,31377,98535
1003230,57048,77958,95398,59985,290389
1003231,5701,50461,86215,3496,145873
1003232,48850,95947,63257,88299,296353
1003233,74506,26739,40930,87777,229952
1003234,24515,65863,80830,37001,208209
1003235,30737,99384,62084,2856,195061
1003236,46966,10863,50255,60633,168717
1003237,33211,35634,18691,30216,117752
1003238,57819,81265,43760,6617,189461
1003239,60826,79150,90248,66907,297131
1003240,76315,42287,91691,71450,281743
1003241,87274,14653,23274,5789,130990
1003242,88045,28972,66726,14617,198360
1003243,39663,16644,52900,777,109984
1003244,69948,35748,77220,91459,274375
1003245,4472,23841,97135,25574,151022
1003246,97742,13077,18257,75946,205022
1003247,81765,89189,41382,5177,217513
1003248,49511,36669,93554,65979,245713
1003249,91714,15530,49373,13812,170429
1003250,61425,39729,24628,34200,159982
1003251,54586,8935,70350,74818,208689
1003252,31868,11468,11901,72996,128233
1003253,85840,13829,54783,14553,169005
1003254,35680,22024,33993,30139,121836
1003255,74973,18931,77082,38234,209220
1003256,65388,60203,51179,27835,204605
1003257,76755,12449,98113,34846,222163
1003258,41820,43214,92289,29211,206534
1003259,77745,13675,91422,24444,207286
1003260,71254,52191,67150,21249,211844
1003261,52209,40924,11026,28629,132788
1003262,8020,59930,92182,16534,176666
1003263,64017,75205,28489,91845,259556
1003264,99726,51783,22943,90853,265305
1003265,79548,94794,71480,84705,330527
1003266,83455,2864,2280,51472,140071
1003267,46493,80169,11971,94400,233033
1003268,90974,1024,26915,40214,159127
1003269,91666,9536,68262,84640,254104
1003270,10825,29609,98910,37100,176444
1003271,50125,29589,53691,17008,150413
1003272,48409,54651,2463,56594,162117
1003273,75327,93814,5857,40444,215442
1003274,74584,33926,79793,2812,191115
1003275,41538,60117,80781,75117,257553
1003276,8979,2746,73883,73644,159252
1003277,66789,5947,43864,18721,135321
1003278,14757,40838,48744,28005,132344
1003279,82911,23704,7607,80572,194794
1003280,97076,88656,6826,48174,240732
1003281,54482,79957,323,60987,195749
1003282,7021,31533,84740,52593,175887
1003283,25420,36591,46837,45815,154663
1003284,69724,98988,69703,19373,257788
1003285,53700,85557,166,29256,168679
1003286,94265,10620,39067,83801,227753
1003287,13431,19022,77508,34014,143975
1003288,28573,23202,56609,86559,194943
1003289,78353,80597,16777,74653,250380
1003290,45099,7627,5740,57475,115941
1003291,23475,6801,19950,21324,71550
1003292,80170,12541,23849,74970,191530
1003293,55690,50929,76202,34684,217505
1003294,28202,45547,7192,76967,157908
1003295,29514,18923,54884,81729,185050
1003296,90406,75865,28610,38025,232906
1003297,35132,95759,94461,11914,237266
1003298,50061,21419,84411,98048,253939
1003299,4569,57767,70926,75417,208679
1003300,2926,99952,83211,61116,247205
1003301,31102,21060,92133,2067,146362
1003302,82959,91964,43899,74606,293428
1003303,47517,14732,98043,44565,204857
1003304,81191,92612,47207,54045,275055
1003305,921,15059,95787,85350,197117
1003306,41757,15105,21940,58947,137749
1003307,40161,11667,46233,9086,107147
1003308,76847,35664,59374,85285,257170
1003309,20019,10542,62450,3371,96382
1003310,94083,38942,92238,78057,303320
1003311,42817,54024,75279,17014,189134
1003312,89651,21117,26573,47825,185166
1003313,13052,36404,73816,93564,216836
1003314,77394,82371,13430,85185,258380
1003315,80938,17924,14129,71147,184138
1003316,63525,45546,45178,46255,200504
1003317,82561,92858,30704,78007,284130
1003318,51260,18080,2631,72748,144719
1003319,71552,77732,61391,82134,292809
1003320,4870,66779,27953,92640,192242
1003321,61234,50948,57766,76253,246201
1003322,38319,80450,32443,98818,250030
1003323,39627,81711,77460,43343,242141
1003324,27966,3535,1323,6591,39415
1003325,41320,10477,87614,45168,184579
1003326,52462,25724,82049,27411,187646
1003327,23326,75114,17668,5563,121671
1003328,42065,79807,16125,41242,179239
1003329,18043,75193,87017,21111,201364
1003330,78825,28551,62625,19316,189317
1003331,91337,23508,18179,86365,219389
1003332,34218,20844,59335,99261,213658
1003333,93715,21672,89357,33014,237758
1003334,54619,91741,99089,32194,277643
1003335,96452,42744,43411,75407,258014
1003336,50927,79402,97453,56114,283896
1003337,23062,20554,77581,91261,212458
1003338,23236,45624,66077,8575,143512
1003339,4472,59888,51879,76726,192965
1003340,56263,76353,97765,40601,270982
1003341,40570,26611,43918,35949,147048
1003342,61158,53920,83917,98486,297481
1003343,40415,81988,232,38249,160884
1003344,64350,71814,55706,44018,235888
1003345,91054,35728,65986,30122,222890
1003346,49310,79986,60074,81957,271327
1003347,41376,74211,1616,17500,134703
1003348,78589,61189,58215,86839,284832
1003349,86284,39313,783,25722,152102
1003350,17690,33023,5443,57176,113332
1003351,9854,83532,6203,87075,186664
1003352,59278,20662,43782,21491,145213
1003353,88978,30172,15746,45959,180855
1003354,15112,41814,78998,82487,218411
1003355,47121,6490,19953,92296,165860
1003356,62976,33508,69379,67989,233852
1003357,60624,70203,2565,84193,217585
1003358,65131,53104,84907,35034,238176
1003359,52272,54344,52465,11240,170321
1003360,8902,83193,90917,1337,184349
1003361,23956,78825,16967,72949,192697
1003362,7599,90568,69422,91923,259512
1003363,89322,56731,59629,27232,232914
1003364,68445,59582,76716,73697,278440
1003365,96802,68230,70273,39200,274505
1003366,45422,83365,69103,24811,222701
1003367,99149,72140,10755,68800,250844
1003368,40995,82875,76198,60559,260627
1003369,71489,488,47,21208,93232
1003370,88219,87013,34908,90941,301081
1003371,16956,31445,76073,88751,213225
1003372,39757,4181,25812,45743,115493
1003373,38902,36410,44142,78680,198134
1003374,6264,60037,86168,40313,192782
1003375,96634,50034,58532,13756,218956
1003376,24658,17429,69758,52182,164027
1003377,10694,68183,80569,84977,244423
1003378,24077,4205,16058,84404,128744
1003379,19425,27902,74003,49149,170479
1003380,31612,71430,1947,32777,137766
1003381,69948,18677,33367,46409,168401
1003382,36037,47221,78841,67288,229387
1003383,10893,21601,82405,56801,171700
1003384,94126,33928,10393,70983,209430
1003385,4202,70695,66655,1871,143423
1003386,30530,30706,25039,35642,121917
1003387,59894,84061,84941,62814,291710
1003388,19982,58730,16329,77826,172867
1003389,76770,70546,63260,47210,257786
1003390,76173,4048,58881,75541,214643
1003391,18271,41245,44984,35372,139872
1003392,23436,39525,10653,10697,84311
1003393,36253,79582,97728,45016,258579
1003394,52594,94416,87039,73650,307699
1003395,21799,38939,96995,5368,163101
1003396,32957,53153,59701,95923,241734
1003397,91060,18902,23458,88059,221479
1003398,6037,7319,28609,90539,132504
1003399,78990,73635,78047,97991,328663
1003400,55276,12296,76108,84968,228648
1003401,71949,93087,17345,73275,255656
1003402,90743,46284,60047,18833,215907
1003403,93162,18813,30094,92872,234941
1003404,19924,69991,26787,51935,168637
1003405,94950,93210,56251,70855,315266
1003406,30435,87282,33751,48627,200095
1003407,32606,46193,56629,18381,153809
1003408,69531,77241,30255,65098,242125
1003409,96338,60418,81257,67031,305044
1003410,54628,41705,82441,82486,261260
1003411,91919,90020,77495,26315,285749
1003412,68759,93805,70560,38679,271803
1003413,13077,70532,5971,76621,166201
1003414,51284,37805,72143,68210,229442
1003415,93753,33826,72222,90107,289908
1003416,45277,19307,65824,27302,157710
1003417,97635,55202,7831,5955,166623
1003418,79827,44100,64874,40597,229398
1003419,83633,85585,2691,27129,199038
1003420,50816,83293,71419,78231,283759
1003421,13203,28308,16758,88060,146329
1003422,50776,19830,60284,49710,180600
1003423,37534,19082,7571,18272,82459
1003424,59888,61879,81052,8401,211220
1003425,52656,76217,10431,3722,143026
1003426,84297,76268,27073,19490,207128
1003427,94747,86345,87198,9122,277412
1003428,92606,3674,34938,21508,152726
1003429,43740,77962,22704,70022,214428
1003430,68037,1432,73663,30716,173848
1003431,42645,26392,82361,31026,182424
1003432,70881,72253,36955,40735,220824
1003433,92299,56345,32039,77963,258646
1003434,55075,84284,95911,13782,249052
1003435,41759,22460,12174,71334,147727
1003436,98286,81357,84177,79854,343674
1003437,90666,81855,36249,66673,275443
1003438,13865,26577,52550,68274,161266
1003439,80648,68494,34488,22739,206369
1003440,77317,76822,5852,80681,240672
1003441,72091,96392,52422,71802,292707
1003442,18041,46937,46124,512,111614
1003443,51767,38386,5169,41973,137295
1003444,59009,51904,15454,67606,193973
1003445,84784,8391,82081,31947,207203
1003446,17377,98715,88143,14977,219212
1003447,70221,99633,20155,63110,253119
1003448,91348,20169,63932,67978,243427
1003449,65973,19082,71396,98161,254612
1003450,10104,77107,22453,27448,137112
1003451,99371,44642,98031,22228,264272
1003452,70792,64991,16761,59608,212152
1003453,39166,84091,14467,31608,169332
1003454,51258,54234,95339,54543,255374
1003455,36982,63918,93920,85912,280732
1003456,86077,33202,95050,77458,291787
1003457,60616,20202,89336,63099,233253
1003458,47346,51181,66958,25416,190901
1003459,2517,79754,92026,14767,189064
1003460,86154,39197,35896,55809,217056
1003461,31483,14673,15106,97764,159026
1003462,43919,52769,45930,76728,219346
1003463,58285,78032,31459,33742,201518
1003464,45520,69064,32821,86191,233596
1003465,7885,77473,79128,88545,253031
1003466,82677,70648,72712,22156,248193
1003467,49904,82867,31122,30860,194753
1003468,28195,81317,61638,19580,190730
1003469,566,7091,18521,17932,44110
1003470,57483,39889,63788,40921,202081
1003471,23655,31231,68067,66619,189572
1003472,36255,39814,97100,53757,226926
1003473,51486,15063,14802,94078,175429
1003474,17317,94445,34702,88026,234490
1003475,54280,15794,95196,93731,259001
1003476,66415,6261,19963,24443,117082
1003477,86228,3524,19202,85854,194808
1003478,73322,10132,66511,43210,193175
1003479,39848,22120,15039,20025,97032
1003480,95215,24144,34849,49081,203289
1003481,76161,78492,62789,60886,278328
1003482,38939,15161,18809,78600,151509
1003483,21666,39720,91980,81998,235364
1003484,89961,85235,25449,957,201602
1003485,95206,19436,40267,65394,220303
1003486,65672,10365,92985,22306,191328
1003487,45160,97746,9582,65907,218395
1003488,69329,88039,10795,73872,242035
1003489,66577,58220,2904,58411,186112
1003490,14610,36141,60124,22682,133557
1003491,91685,74351,23471,11462,200969
1003492,12446,58982,96584,15784,183796
1003493,99771,4683,18035,23545,146034
1003494,42446,93894,31426,96252,264018
1003495,39732,73243,32125,73686,218786
1003496,85724,38058,22566,83733,230081
1003497,21286,27183,91890,78774,219133
1003498,25745,38850,9562,46830,120987
1003499,40868,51473,83877,98380,274598
1003500,67326,3861,56441,47884,175512
1003501,73006,27731,42594,50227,193558
1003502,81377,16846,33730,37185,169138
1003503,25774,32484,94149,59459,211866
1003504,86265,36117,7279,22585,152246
1003505,51975,70132,29383,70752,222242
1003506,3979,34502,85599,12820,136900
1003507,7576,68488,87549,1112,164725
1003508,43316,10356,36480,52899,143051
1003509,91507,2540,95523,21600,211170
1003510,90931,60454,94049,65205,310639
1003511,22872,56016,72499,96992,248379
1003512,62687,53104,10489,53055,179335
1003513,91538,85773,19672,97273,294256
1003514,37513,82178,8893,7214,135798
1003515,46410,18051,66877,72092,203430
1003516,20470,5824,28029,41446,95769
1003517,59538,6489,71087,79388,216502
1003518,40839,81442,75467,19706,217454
1003519,92838,59890,88506,53527,294761
1003520,13624,47242,6282,87972,155120
1003521,18493,38289,20669,72372,149823
1003522,93581,25004,67256,20028,205869
1003523,87553,19294,17350,80845,205042
1003524,61048,79619,54214,11557,206438
1003525,82873,43107,56948,22448,205376
1003526,58715,46950,60252,34078,199995
1003527,92785,56691,11914,86652,248042
1003528,46005,53819,57745,82362,239931
1003529,96481,74906,12539,53331,237257
1003530,60075,2703,56331,14231,133340
1003531,10325,72713,22155,75841,181034
1003532,84960,62701,9068,24189,180918
1003533,37544,91247,75497,80467,284755
1003534,15387,75744,10512,43166,144809
1003535,47896,98168,97072,98532,341668
1003536,77838,85633,1814,19910,185195
1003537,70362,75476,3229,97178,246245
1003538,59952,99323,5862,285,165422
1003539,55887,64622,7729,52007,180245
1003540,11304,17992,49394,53869,132559
1003541,99587,97990,10548,79173,287298
1003542,34106,32786,99777,89556,256225
1003543,40023,25698,49783,89127,204631
1003544,68976,62590,34358,24907,190831
1003545,37316,80632,46425,54730,219103
1003546,60314,2677,44990,15613,123594
1003547,57968,19985,71304,17735,166992
1003548,12855,94538,48309,31357,187059
1003549,54923,97616,70980,87628,311147
1003550,5008,27254,36170,18025,86457
1003551,69219,82044,44286,75477,271026
1003552,55832,25468,62550,8588,152438
1003553,10555,56788,47879,75383,190605
1003554,25018,92746,61426,42684,221874
1003555,29941,23457,24052,49209,126659
1003556,10423,77618,91680,80985,260706
1003557,50240,68328,96496,89730,304794
1003558,72664,73967,59040,47836,253507
1003559,94571,35789,6792,28775,165927
1003560,2298,73846,38351,63426,177921
1003561,46543,65998,40173,87149,239863
1003562,36039,59983,46356,1033,143411
1003563,19141,42677,7634,92350,161802
1003564,88573,52188,46067,73292,260120
1003565,53975,47873,15407,53359,170614
1003566,23559,26866,87685,53346,191456
1003567,89106,55563,31513,82351,258533
1003568,28300,62196,63149,48527,202172
1003569,28744,42781,54600,80653,206778
1003570,50875,19826,22986,77053,170740
1003571,60866,51634,77269,68223,257992
1003572,94335,1616,13473,79695,189119
1003573,71586,15524,69634,24147,180891
1003574,40169,25276,56484,93535,215464
1003575,58496,56091,64634,86275,265496
1003576,64876,82375,32750,14796,194797
1003577,77287,18633,22261,62721,180902
1003578,65250,89476,31872,54242,240840
1003579,66469,59784,18173,17983,162409
1003580,48195,34346,92542,62011,237094
1003581,13214,11452,1316,79670,105652
1003582,5160,69564,68416,12510,155650
1003583,49683,55525,72484,74149,251841
1003584,39557,73184,55724,98721,267186
1003585,37305,2799,4698,47385,92187
1003586,96072,38823,6435,39914,181244
1003587,46064,21441,7686,97287,172478
1003588,67584,30351,89047,61569,248551
1003589,42200,38146,93747,4796,178889
1003590,26086,5227,54476,50412,136201
1003591,41125,69585,23181,72484,206375
1003592,56836,99490,38987,92793,288106
1003593,27225,56753,73412,47221,204611
1003594,68443,75777,55828,90139,290187
1003595,14862,12159,4681,2270,33972
1003596,31448,54028,46819,87448,219743
1003597,67704,94335,56603,50868,269510
1003598,84898,69032,29719,17419,201068
1003599,82329,22131,67107,93966,265533
1003600,1386,68641,27021,78185,175233
1003601,95093,84224,85532,1486,266335
1003602,30931,5576,89301,42325,168133
1003603,4776,88708,21837,42882,158203
1003604,42586,95070,99579,52145,289380
1003605,93419,28897,5848,57134,185298
1003606,82216,79454,80007,54189,295866
1003607,23430,92105,80274,54836,250645
1003608,10854,84156,42504,42763,180277
1003609,99146,92088,71076,34612,296922
1003610,67361,33279,79754,63379,243773
1003611,38945,62063,95794,89376,286178
1003612,18399,93694,26934,62775,201802
1003613,64866,59522,60244,95198,279830
1003614,18823,1189,88739,22595,131346
1003615,45913,96057,69915,69570,281455
1003616,27386,78522,11807,40450,158165
1003617,55241,87358,704,83636,226939
1003618,44989,25319,83456,27420,181184
1003619,48617,32523,22267,74716,178123
1003620,59217,70201,91373,76042,296833
1003621,22993,59764,35761,88354,206872
1003622,39213,81192,65990,62044,248439
1003623,42346,13635,99536,19586,175103
1003624,68127,34878,97615,88012,288632
1003625,78403,54591,13403,48935,195332
1003626,72776,91102,72113,39221,275212
1003627,78750,43576,77479,28503,228308
1003628,7437,51564,77062,32594,168657
1003629,41055,90801,44025,93457,269338
1003630,93559,99348,90393,34671,317971
1003631,34403,84328,54687,13607,187025
1003632,11926,93302,25814,19305,150347
1003633,15380,82383,4263,60714,162740
1003634,77928,33971,89669,73043,274611
1003635,21108,16930,59251,54273,151562
1003636,87451,76282,59399,58921,282053
1003637,5888,63460,86553,14653,170554
1003638,48656,8558,63395,71245,191854
1003639,81955,6249,24568,38769,151541
1003640,20736,96910,16541,32396,166583
1003641,44812,52595,45026,80026,222459
1003642,9984,27094,46681,84226,167985
1003643,3801,63798,60516,57118,185233
1003644,9955,11363,5143,23940,50401
1003645,56679,26761,80348,76394,240182
1003646,60635,77670,89390,62031,289726
1003647,15311,70490,20501,45944,152246
1003648,79213,22289,33966,100000,235468
1003649,16259,576,90052,32033,138920
1003650,752,37427,69046,59594,166819
1003651,44751,40677,11366,3663,100457
1003652,86423,70795,67739,80275,305232
1003653,72864,28104,96712,81109,278789
1003654,46596,91024,81298,7856,226774
1003655,58693,20111,54031,26009,158844
1003656,78331,3921,31988,15636,129876
1003657,97995,20205,76461,95404,290065
1003658,88428,42294,8833,15100,154655
1003659,64247,20335,50421,56831,191834
1003660,71405,38091,10957,35212,155665
1003661,11451,40623,27475,90779,170328
1003662,90994,60669,74347,46390,272400
1003663,14597,20107,57600,56042,148346
1003664,60840,5633,21696,46229,134398
1003665,58715,71975,91470,26298,248458
1003666,19088,72228,40091,94712,226119
1003667,22802,53671,73903,70868,221244
1003668,67593,452,10173,56874,135092
1003669,96260,38006,225,14288,148779
1003670,9878,77288,73088,4880,165134
1003671,35531,44373,91963,26398,198265
1003672,66051,89566,49228,63791,268636
1003673,93750,9526,72247,91165,266688
1003674,83438,54559,72626,28887,239510
1003675,71311,54375,50092,96233,272011
1003676,2964,89320,91229,63871,247384
1003677,14581,3050,19279,77297,114207
1003678,6522,54319,9242,5507,75590
1003679,11527,62700,99427,32548,206202
1003680,75116,9783,55440,62887,203226
1003681,10289,76768,83650,86750,257457
1003682,59213,21070,99268,78501,258052
1003683,33029,59081,40818,19092,152020
1003684,53810,11891,60012,14720,140433
1003685,17552,431,17360,15965,51308
1003686,83905,86049,42222,93379,305555
1003687,10179,91579,6962,39903,148623
1003688,54047,58827,35600,87861,236335
1003689,49581,6949,34498,91065,182093
1003690,40359,22762,98822,56414,218357
1003691,33524,20815,97466,49606,201411
1003692,44657,50621,89536,93521,278335
1003693,93257,25853,53855,72767,245732
1003694,58618,49630,54661,76307,239216
1003695,50197,17995,3535,82870,154597
1003696,32412,27052,13369,25053,97886
1003697,38195,49291,2462,55429,145377
1003698,94921,95784,88503,78063,357271
1003699,92950,73775,81148,36367,284240
1003700,96644,61378,28419,98856,285297
1003701,33309,28505,45110,88728,195652
1003702,49151,7312,90704,68925,216092
1003703,41077,47232,4501,27613,120423
1003704,13989,5124,4170,26482,49765
1003705,34285,99755,83516,71728,289284
1003706,90027,44538,13836,3012,151413
1003707,68038,56718,16394,39770,180920
1003708,63579,87125,11733,63729,226166
1003709,69304,20669,73123,70463,233559
1003710,16185,4619,6925,88037,115766
1003711,6385,22726,33143,96087,158341
1003712,33124,88543,59732,80137,261536
1003713,58343,20901,31619,89504,200367
1003714,9311,64981,98160,22563,195015
1003715,82801,89105,482,51971,224359
1003716,9839,1071,92837,71814,175561
1003717,31431,13561,93093,31063,169148
1003718,95734,80967,60774,93882,331357
1003719,8629,18644,15689,39093,82055
1003720,6636,63400,71442,16936,158414
1003721,69158,33722,97061,87961,287902
1003722,16844,51201,64952,58331,191328
1003723,63459,25046,60149,77077,225731
1003724,52291,39635,869,47283,140078
1003725,23943,24035,34836,28994,111808
1003726,70381,53460,54532,38513,216886
1003727,17953,11568,91708,92027,213256
1003728,2995,93911,83621,59479,240006
1003729,90747,75361,49230,76466,291804
1003730,37938,40274,16705,97695,192612
1003731,71815,83563,18394,15987,189759
1003732,65309,23318,76581,2773,167981
1003733,70810,45981,53849,84521,255161
1003734,57356,94745,70720,70889,293710
1003735,95649,17937,14185,81039,208810
1003736,40683,99906,37767,19202,197558
1003737,86505,65803,87562,92060,331930
1003738,30421,87449,80502,49485,247857
1003739,62039,10949,84918,94830,252736
1003740,93825,34308,98487,68368,294988
1003741,9221,88818,23442,8260,129741
1003742,30968,43319,90727,42516,207530
1003743,96295,66722,4658,97848,265523
1003744,34803,73027,63339,52074,223243
1003745,26199,96331,27077,43319,192926
1003746,89343,94428,39531,43988,267290
1003747,47973,47955,34646,99576,230150
1003748,24173,60260,5041,8014,97488
1003749,82184,47032,62559,32101,223876
1003750,67043,17853,18653,62580,166129
1003751,25044,9227,53285,1281,88837
1003752,1578,8730,60246,9659,80213
1003753,12732,83415,50874,48772,195793
1003754,21065,94543,6105,8606,130319
1003755,29578,2164,95255,83273,210270
1003756,89434,95469,21302,74082,280287
1003757,6763,80707,33537,71749,192756
1003758,2661,77463,68735,18686,167545
1003759,58087,21251,13155,41949,134442
1003760,40074,34874,7576,10846,93370
1003761,95511,62612,94600,12403,265126
1003762,26702,38179,59509,46329,170719
1003763,19281,68125,91634,3627,182667
1003764,51352,16062,27963,72920,168297
1003765,28541,40816,74258,73065,216680
1003766,10002,64394,46046,98526,218968
1003767,77990,71191,87404,65684,302269
1003768,13752,90911,6376,19229,130268
1003769,4812,30827,58971,94377,188987
1003770,2519,57335,49129,49980,158963
1003771,20708,81457,87780,9951,199896
1003772,97979,44486,21619,65513,229597
1003773,54570,32223,49611,20432,156836
1003774,77691,96746,65930,88919,329286
1003775,71503,34279,95896,14053,215731
1003776,48029,61842,46304,71019,227194
1003777,27073,71422,56292,50415,205202
1003778,747,17356,25891,10184,54178
1003779,36202,77871,91905,19048,225026
1003780,59127,74938,84604,57452,276121
1003781,65500,48235,28286,74290,216311
1003782,19886,62181,6639,70052,158758
1003783,89687,34781,83297,33739,241504
1003784,65332,50673,43388,37182,196575
1003785,11050,70247,62422,13797,157516
1003786,31713,55086,26823,78692,192314
1003787,29294,96412,38331,69416,233453
1003788,8839,61351,63451,37635,171276
1003789,87257,11818,6447,57803,163325
1003790,24242,89997,32130,94212,240581
1003791,42451,53131,79308,37415,212305
1003792,79672,93151,32586,91912,297321
1003793,61153,61415,99841,73694,296103
1003794,82326,23465,65721,11252,182764
1003795,59654,78435,41167,74684,253940
1003796,67060,47213,42165,51666,208104
1003797,59201,55025,45138,49985,209349
1003798,59819,63385,96153,64053,283410
1003799,23024,51498,48840,70927,194289
1003800,39351,66407,27819,85841,219418
1003801,94358,9841,12772,68306,185277
1003802,40846,97705,46295,88363,273209
1003803,29265,25038,89470,35866,179639
1003804,63366,29968,65082,30650,189066
1003805,88111,52676,55636,31697,228120
1003806,40313,1514,36680,12084,90591
1003807,82300,16606,7364,68672,174942
1003808,70282,89624,70102,70204,300212
1003809,89462,52079,92495,73920,307956
1003810,65176,97315,45223,80149,287863
1003811,57062,97504,87912,79301,321779
1003812,78054,44306,40585,93772,256717
1003813,66923,79753,80488,88188,315352
1003814,93367,48983,21634,13170,177154
1003815,37609,97307,48557,77234,260707
1003816,16159,56984,56343,5440,134926
1003817,13197,72483,69959,53590,209229
1003818,15518,10673,78195,99338,203724
1003819,64260,24128,28029,98230,214647
1003820,83532,24336,66125,36032,210025
1003821,96869,61127,13653,23083,194732
1003822,29224,5139,29065,90260,153688
1003823,46146,96888,20246,19092,182372
1003824,14766,52638,94424,89619,251447
1003825,49510,15839,49483,36568,151400
1003826,90798,88646,53569,52758,285771
1003827,9846,44507,53144,76493,183990
1003828,11844,4686,79435,6538,102503
1003829,10733,73692,78237,6512,169174
1003830,18428,52721,99950,4154,175253
1003831,45269,33525,44938,14145,137877
1003832,43284,94081,14093,34336,185794
1003833,61514,60277,16476,86247,224514
1003834,70393,2196,52717,29971,155277
1003835,36128,36991,34401,43190,150710
1003836,77804,74952,88175,83806,324737
1003837,9645,4807,59992,44794,119238
1003838,85532,55224,52093,87477,280326
1003839,65669,64535,73130,43711,247045
1003840,22146,35364,54051,6979,118540
1003841,43541,98230,90091,15459,247321
1003842,50333,32724,63821,88194,235072
1003843,44726,55378,37910,42383,180397
1003844,14613,49820,81365,52631,198429
1003845,90232,1431,5602,70407,167672
1003846,66664,69597,51526,83100,270887
1003847,82336,45189,93824,81470,302819
1003848,5386,77343,44143,72628,199500
1003849,2442,98870,11990,17105,130407
1003850,95159,29217,77749,33596,235721
1003851,40936,23183,97334,51446,212899
1003852,7027,17128,2553,42114,68822
1003853,43672,12496,98601,90461,245230
1003854,9689,7911,19846,139,37585
1003855,26703,70529,85700,36637,219569
1003856,82334,35653,55453,86345,259785
1003857,20544,11482,3946,72404,108376
1003858,62355,48547,41062,1755,153719
1003859,73249,34718,57193,63390,228550
1003860,96803,61249,56469,88052,302573
1003861,49717,28844,14850,98792,192203
1003862,58970,36586,31522,23033,150111
1003863,63373,26368,52728,43729,186198
1003864,43462,76205,72481,33536,225684
1003865,3271,51228,28032,35719,118250
1003866,571,17561,66750,26259,111141
1003867,68246,69225,55206,47693,240370
1003868,56848,3672,15820,36452,112792
1003869,54268,86394,67770,48951,257383
1003870,16498,38251,8875,50975,114599
1003871,76979,42315,54987,68990,243271
1003872,53181,73501,55954,96363,278999
1003873,90133,83972,79186,29758,283049
1003874,87285,2275,5759,79045,174364
1003875,53810,33934,96993,56085,240822
1003876,9931,11903,72505,90048,184387
1003877,90742,93563,16033,43688,244026
1003878,14557,28517,96580,3833,143487
1003879,82009,31518,76467,11255,201249
1003880,76752,37369,22119,79570,215810
1003881,89925,97680,84699,19323,291627
1003882,88655,71825,94009,91432,345921
1003883,16519,81241,22865,88704,209329
1003884,21374,2492,3907,41320,69093
1003885,91629,47880,27514,46781,213804
1003886,15364,61876,74857,30991,183088
1003887,29052,73798,96062,56532,255444
1003888,42673,6666,84807,42903,177049
1003889,24818,34176,43560,46273,148827
1003890,42317,94787,1324,13842,152270
1003891,68268,56988,44515,67126,236897
1003892,97835,24084,90196,10381,222496
1003893,93094,80829,37651,83007,294581
1003894,32662,68061,70509,54946,226178
1003895,34014,66741,69463,96284,266502
1003896,95680,23747,74809,56164,250400
1003897,42216,3207,45640,11001,102064
1003898,43082,69150,16918,64315,193465
1003899,76613,92652,66852,22293,258410
1003900,97778,38244,13611,57772,207405
1003901,10979,85601,70309,39471,206360
1003902,87712,86915,34948,10309,219884
1003903,34936,21291,45510,87793,189530
1003904,4397,28024,34295,76717,143433
1003905,2471,12242,70470,71550,156733
1003906,72109,55888,34442,37317,199756
1003907,15537,41340,9645,39581,106103
1003908,49013,93372,45181,18627,206193
1003909,44470,53227,34844,18696,151237
1003910,19598,52035,67426,70464,209523
1003911,77846,97168,70854,50311,296179
1003912,42500,29780,4646,32238,109164
1003913,33651,48951,82092,66842,231536
1003914,20997,97292,80167,85222,283678
1003915,55959,7888,59098,1338,124283
1003916,57148,64263,66121,24919,212451
1003917,32626,63323,32700,60371,189020
1003918,49575,4498,60168,44777,159018
1003919,8184,6565,42897,49601,107247
1003920,67632,60978,77969,88680,295259
1003921,43700,8925,37931,7601,98157
1003922,46425,260,98674,66689,212048
1003923,22668,57194,637,23386,103885
1003924,47572,72710,22579,31042,173903
1003925,37369,26235,92980,9423,166007
1003926,7342,98785,76050,35889,218066
1003927,97446,68494,25193,29187,220320
1003928,24911,41026,34141,44000,144078
1003929,57358,42456,46176,87212,233202
1003930,99751,99330,36684,87252,323017
1003931,98385,34510,35636,71619,240150
1003932,30360,96091,69084,93826,289361
1003933,93772,28805,2755,91532,216864
1003934,14188,94845,36510,41346,186889
1003935,6950,71315,52566,81253,212084
1003936,39978,61834,81505,79246,262563
1003937,62072,74400,37812,88806,263090
1003938,72445,5740,6163,5000,89348
1003939,53473,95100,89040,2646,240259
1003940,85618,8742,34537,88690,217587
1003941,80986,75089,79482,8384,243941
1003942,9166,32426,33016,52866,127474
1003943,23529,76216,73060,77292,250097
1003944,32489,31349,26874,17010,107722
1003945,65599,33724,84035,15765,199123
1003946,74033,38043,34084,11607,157767
1003947,98006,67379,79272,15323,259980
1003948,5163,31553,58136,41444,136296
1003949,25467,16982,68765,3446,114660
1003950,85434,1546,90602,15019,192601
1003951,4145,93162,90697,18440,206444
1003952,98082,25291,73150,9763,206286
1003953,29246,79346,94159,47049,249800
1003954,68508,95268,8273,74329,246378
1003955,31553,34226,41390,91088,198257
1003956,85253,48710,36436,45911,216310
1003957,19439,29344,73388,18031,140202
1003958,49210,3428,85532,56518,194688
1003959,37317,90589,38160,44861,210927
1003960,3043,27182,20183,51487,101895
1003961,36173,84407,83363,80711,284654
1003962,529,47022,14855,19113,81519
1003963,49014,42686,5454,43283,140437
1003964,28011,10043,76442,47535,162031
1003965,96176,26395,94885,76571,294027
1003966,85877,34277,70040,27942,218136
1003967,75538,99512,10925,25087,211062
1003968,45004,67109,64481,63506,240100
1003969,85580,2707,20174,67074,175535
1003970,60578,24492,50531,82598,218199
1003971,85534,99632,12948,84648,282762
1003972,48989,61394,92525,51581,254489
1003973,53296,90494,59860,65895,269545
1003974,79390,81686,98262,34927,294265
1003975,10802,61424,27113,28017,127356
1003976,53969,7629,12795,83411,157804
1003977,57373,59312,69142,17452,203279
1003978,63962,45655,11211,91433,212261
1003979,27872,34723,28638,80147,171380
1003980,40528,93070,99467,35144,268209
1003981,65625,10099,88532,76353,240609
1003982,45854,5679,37014,56918,145465
1003983,75669,41506,72074,36944,226193
1003984,42369,18211,95206,64608,220394
1003985,32636,31593,93211,25570,183010
1003986,104,71603,59619,10052,141378
1003987,26769,83544,79107,58769,248189
1003988,47682,56158,12287,73759,189886
1003989,47806,88720,72913,64313,273752
1003990,68980,43271,9135,6684,128070
1003991,5378,51808,30480,68193,155859
1003992,58743,43179,69925,12521,184368
1003993,46636,79,79171,82309,208195
1003994,92606,53284,51886,78957,276733
1003995,48954,1113,7777,32868,90712
1003996,34402,73031,17576,12626,137635
1003997,64180,59703,45373,49917,219173
1003998,86722,75138,97265,9249,268374
1003999,59478,59292,2845,74734,196349
1004000,65856,64183,34584,44477,209100
1004001,89820,73757,66027,44176,273780
1004002,54979,98405,12405,37576,203365
1004003,66783,6180,63760,38173,174896
1004004,78589,37570,37600,23210,176969
1004005,72073,22261,72532,51748,218614
1004006,16099,70518,4040,30104,120761
1004007,55498,16712,15894,10770,98874
1004008,13460,34974,61677,3118,113229
1004009,46647,34951,66341,28043,175982
1004010,24739,8874,8349,67402,109364
1004011,18873,40319,13665,7422,80279
1004012,31133,49615,18815,41314,140877
1004013,7362,92873,80484,57239,237958
1004014,2779,48560,20652,1405,73396
1004015,79302,21724,29370,77945,208341
1004016,99635,73356,30722,60387,264100
1004017,84850,37907,86536,61281,270574
1004018,96286,59353,86052,34659,276350
1004019,61844,15355,8519,19790,105508
1004020,60861,80269,57404,55935,254469
1004021,78994,9200,67147,76696,232037
1004022,24342,30152,81957,86746,223197
1004023,37149,91211,78901,93613,300874
1004024,70463,76237,84185,66054,296939
1004025,3259,26982,30029,87186,147456
1004026,23118,8868,89798,50129,171913
1004027,52961,7542,20846,32755,114104
1004028,50034,31635,51967,18087,151723
1004029,56723,45384,80769,72976,255852
1004030,97122,56783,96333,24515,274753
1004031,4675,57827,58759,33697,154958
1004032,17066,81221,73295,88021,259603
1004033,15719,17038,76972,74534,184263
1004034,75600,34537,80062,21157,211356
1004035,41725,85148,45689,18144,190706
1004036,60286,68366,33875,54784,217311
1004037,56931,43494,59338,84170,243933
1004038,37719,77958,78477,18678,212832
1004039,23233,40852,33625,43648,141358
1004040,45260,32248,39984,73091,190583
1004041,29424,2584,52897,32475,117380
1004042,52017,51424,44830,32521,180792
1004043,61178,78664,52948,83232,276022
1004044,82537,78753,3423,59056,223769
1004045,16509,60690,60052,17749,155000
1004046,37098,76796,38002,87000,238896
1004047,83762,61423,22004,70929,238118
1004048,42440,36384,9162,35649,123635
1004049,3571,86868,79514,17709,187662
1004050,95964,95806,69555,53656,314981
1004051,68548,58783,94769,23746,245846
1004052,59284,40498,4797,91652,196231
1004053,50589,78882,55428,98690,283589
1004054,91688,62363,24830,4348,183229
1004055,84100,91542,49880,69124,294646
1004056,88384,99215,40404,6246,234249
1004057,52408,94692,28620,96150,271870
1004058,16281,61697,26229,27444,131651
1004059,72391,5779,74574,87927,240671
1004060,35259,83465,92913,32329,243966
1004061,82267,50861,27010,72312,232450
1004062,7664,10549,17953,54715,90881
1004063,68863,84116,61568,44808,259355
1004064,42870,62902,76294,57171,239237
1004065,9979,55532,89045,99179,253735
1004066,61573,29830,92261,25738,209402
1004067,28222,85766,98054,38603,250645
1004068,92554,72384,80658,65695,311291
1004069,39185,49678,81659,53311,223833
1004070,36004,5121,14665,6022,61812
1004071,59062,48479,76671,12645,196857
1004072,63610,4500,82482,12348,162940
1004073,93507,81718,69055,504,244784
1004074,53075,73553,41576,28319,196523
1004075,97611,38373,88498,14196,238678
1004076,86766,6623,87267,69428,250084
1004077,38029,20374,90753,18059,167215
1004078,14147,13867,21990,72718,122722
1004079,26650,33687,34940,86660,181937
1004080,33623,5049,65519,2986,107177
1004081,33589,64216,68707,8967,175479
1004082,40892,14703,49181,37558,142334
1004083,33775,87919,68578,80553,270825
1004084,69154,85191,66209,98608,319162
1004085,10555,5005,39322,3751,58633
1004086,71937,93788,67144,72590,305459
1004087,97752,53600,4343,66252,221947
1004088,96224,23730,27949,79228,227131
1004089,4608,7349,41522,77274,130753
1004090,70008,17184,33702,50538,171432
1004091,97676,86582,40821,86281,311360
1004092,14659,22768,222,93036,130685
1004093,39568,3761,97347,44225,184901
1004094,70651,23651,27106,28036,149444
1004095,83096,2856,62436,15133,163521
1004096,49488,52211,91853,30730,224282
1004097,28112,89563,2377,20765,140817
1004098,72698,42497,43626,14793,173614
1004099,98770,54524,56910,6943,217147
1004100,29277,6118,3580,65051,104026
1004101,35792,15571,72401,11179,134943
1004102,13453,23982,13904,61630,112969
1004103,17765,53030,39202,34798,144795
1004104,32124,37216,64929,28904,163173
1004105,75209,61971,96908,8065,242153
1004106,49176,69348,34846,31006,184376
1004107,50650,82466,94816,54809,282741
1004108,93641,70859,77365,70074,311939
1004109,70316,739,85338,78482,234875
1004110,35684,59600,4150,64078,163512
1004111,24689,75535,51893,64539,216656
1004112,50854,15564,37674,9750,113842
1004113,14632,54852,44269,21603,135356
1004114,15338,98396,46035,66085,225854
1004115,40736,29930,98572,47405,216643
1004116,45129,675,85859,1765,133428
1004117,63543,51707,91187,19845,226282
1004118,47003,5142,9598,66322,128065
1004119,82352,12691,56529,1875,153447
1004120,86758,33120,81848,80497,282223
1004121,1250,49528,87900,73730,212408
1004122,72128,19246,60241,52127,203742
1004123,92468,6236,17511,54064,170279
1004124,21935,32380,2831,6490,63636
1004125,26540,72582,30944,15716,145782
1004126,787,19256,98883,3811,122737
1004127,75982,94440,95477,53171,319070
1004128,33684,78569,25225,70386,207864
1004129,11990,34517,26337,16984,89828
1004130,38367,89718,30052,76271,234408
1004131,77026,67769,81680,68534,295009
1004132,4115,59014,7055,22084,92268
1004133,11316,99806,20973,64111,196206
1004134,81882,56612,19363,30766,188623
1004135,22199,64728,76247,65770,228944
1004136,65617,90384,67189,51273,274463
1004137,76736,78066,55827,24140,234769
1004138,14622,14026,41987,82155,152790
1004139,36777,81723,29392,73219,221111
1004140,23527,65505,35130,54165,178327
1004141,41058,91636,54943,96071,283708
1004142,23725,67045,46966,34433,172169
1004143,97380,83198,44398,60951,285927
1004144,62622,4005,94536,99832,260995
1004145,82644,27345,37525,8719,156233
1004146,34335,17156,81817,22613,155921
1004147,21739,68988,56885,52717,200329
1004148,19890,43351,15919,74273,153433
1004149,38562,23918,62518,54220,179218
1004150,648,80622,68071,75025,224366
1004151,32076,9710,46898,16479,105163
1004152,1276,83223,19921,46439,150859
1004153,61270,25605,64413,4570,155858
1004154,82691,9916,34958,81104,208669
1004155,19847,85217,33186,17382,155632
1004156,30729,90822,98555,30798,250904
1004157,21004,78191,81412,8483,189090
1004158,20019,22040,93238,18997,154294
1004159,31153,4526,40288,13342,89309
1004160,49442,53361,88696,49643,241142
1004161,1521,40339,38564,53446,133870
1004162,54193,26898,55828,96673,233592
1004163,96108,38807,68790,90653,294358
1004164,22179,23825,89563,19965,155532
1004165,28357,53835,5176,81951,169319
1004166,84811,6366,8204,4234,103615
1004167,36599,4808,97849,3549,142805
1004168,11507,51031,27469,67251,157258
1004169,53523,92504,20081,80866,246974
1004170,42272,41417,85359,24084,193132
1004171,6388,32548,6772,64281,109989
1004172,86133,61892,75456,91154,314635
1004173,56072,25090,64845,60156,206163
1004174,15225,41605,59599,41276,157705
1004175,74996,20577,97697,90946,284216
1004176,47796,5524,64623,39995,157938
1004177,7741,70334,40197,56482,174754
1004178,14140,32538,41100,738,88516
1004179,32165,81109,4422,17093,134789
1004180,93101,10594,27231,39941,170867
1004181,29568,65527,82648,94130,271873
1004182,11094,2391,83604,82573,179662
1004183,76030,66426,14256,69149,225861
1004184,5959,42608,16377,24834,89778
1004185,9619,85827,80184,74144,249774
1004186,70404,95896,902,25270,192472
1004187,85494,59992,93790,30881,270157
1004188,93812,50621,44499,53541,242473
1004189,79084,89425,75501,23724,267734
1004190,26432,55197,89573,14497,185699
1004191,65659,56919,61241,44596,228415
1004192,29948,20495,88074,87098,225615
1004193,24193,46595,84992,75198,230978
1004194,21078,79468,87094,80013,267653
1004195,71311,73118,56822,6417,207668
1004196,24083,1059,77964,50243,153349
1004197,6009,61881,32998,40746,141634
1004198,53326,96347,51285,8575,209533
1004199,84495,71192,68556,32330,256573
1004200,877,76018,45458,99065,221418
1004201,64847,8424,90180,83595,247046
1004202,95968,61977,13155,21343,192443
1004203,43619,83417,99645,65114,291795
1004204,91314,13817,33681,86116,224928
1004205,24077,85828,29185,60870,199960
1004206,90956,50243,47665,38542,227406
1004207,38122,10892,63372,87291,199677
1004208,81848,52393,17674,25494,177409
1004209,81646,86792,82112,32826,283376
1004210,77469,86408,53672,88644,306193
1004211,17427,69774,73445,41568,202214
1004212,23890,10982,16235,80024,131131
1004213,88919,61652,29938,69162,249671
1004214,68368,53998,89599,90419,302384
1004215,60406,3275,73289,85900,222870
1004216,69060,64182,82530,27037,242809
1004217,92924,87999,96533,43266,320722
1004218,49060,78187,8225,173,135645
1004219,22454,94899,98828,17160,233341
1004220,18305,81423,14958,40517,155203
1004221,59356,92343,7680,19878,179257
1004222,37243,24612,90968,55462,208285
1004223,73529,88899,16758,83891,263077
1004224,12366,4352,73566,63593,153877
1004225,68147,86834,31237,91216,277434
1004226,36564,1521,24534,16220,78839
1004227,66758,97469,47781,48056,260064
1004228,96935,67873,38098,60116,263022
1004229,69439,62970,49355,15895,197659
1004230,7299,45872,63528,49155,165854
1004231,91857,96660,75486,63093,327096
1004232,90738,50087,5768,36297,182890
1004233,22090,6379,69914,64550,162933
1004234,71224,45402,81647,94502,292775
1004235,11772,10007,52075,32207,106061
1004236,89610,1331,15414,82939,189294
1004237,41592,88596,87376,51515,269079
1004238,40706,83564,7597,52167,184034
1004239,30697,70375,30377,9678,141127
1004240,60931,51392,71167,65008,248498
1004241,53110,11653,92856,7955,165574
1004242,98919,79271,26395,14533,219118
1004243,18497,16543,25464,91640,152144
1004244,46572,14606,4426,68494,134098
1004245,15430,63224,8928,74946,162528
1004246,47873,10441,73557,36028,167899
1004247,39283,83208,56298,28199,206988
1004248,7891,31966,82577,89053,211487
1004249,12824,29037,32326,9283,83470
1004250,44554,27695,52983,98142,223374
1004251,68846,50859,20622,69954,210281
1004252,86505,44807,81323,82246,294881
1004253,81433,3392,75687,46710,207222
1004254,13056,68296,59396,83454,224202
1004255,45403,26421,74712,31940,178476
1004256,20257,31127,25817,2940,80141
1004257,37002,78217,83104,12740,211063
1004258,47298,10726,83098,44439,185561
1004259,99556,50289,35827,5586,191258
1004260,17254,43226,48507,49651,158638
1004261,86471,57321,921,4014,148727
1004262,93071,2069,46122,66905,208167
1004263,29327,90960,85239,74660,280186
1004264,89835,73039,35088,16633,214595
1004265,34817,73506,41551,95107,244981
1004266,40106,27241,67255,25370,159972
1004267,24359,47181,43618,61787,176945
1004268,55647,43997,17537,67456,184637
1004269,81507,75584,59698,16767,233556
1004270,50420,60323,9899,33466,154108
1004271,50572,90760,77608,55846,274786
1004272,19536,22409,98751,2841,143537
1004273,28493,38152,10509,699,77853
1004274,87305,48077,40411,60834,236627
1004275,28684,78067,82300,15342,204393
1004276,34997,50528,49972,12035,147532
1004277,66955,18412,52646,36247,174260
1004278,70293,32880,31740,18640,153553
1004279,82986,31654,90364,85281,290285
1004280,60061,64778,99201,87390,311430
1004281,75936,30934,9445,55655,171970
1004282,9737,11413,423,366,21939
1004283,59488,82548,48120,94980,285136
1004284,77863,30716,78653,23821,211053
1004285,72252,91032,97433,78244,338961
1004286,94538,16659,26065,71577,208839
1004287,19461,597,88177,29671,137906
1004288,52220,40790,80446,33226,206682
1004289,40679,97429,19989,34847,192944
1004290,85365,50057,38644,28233,202299
1004291,40500,35728,85321,63343,224892
1004292,35044,37495,43198,52950,168687
1004293,84714,23762,39445,45933,193854
1004294,62924,22415,78535,87488,251362
1004295,92360,11683,65389,61234,230666
1004296,69114,14774,86020,40288,210196
1004297,40520,13844,55914,75925,186203
1004298,3663,47792,99949,46246,197650
1004299,74807,17184,68504,33910,194405
1004300,38040,77198,78907,4379,198524
1004301,28505,71776,20956,11968,133205
1004302,69213,59139,11478,39280,179110
1004303,96150,25433,50567,1543,173693
1004304,11166,54143,39688,6043,111040
1004305,30229,87028,40999,69326,227582
1004306,442,45755,88155,50040,184392
1004307,60109,39408,72772,7222,179511
1004308,54197,54889,37580,23891,170557
1004309,82794,82292,3499,63580,232165
1004310,64540,46253,54741,78451,243985
1004311,54223,33521,60321,63983,212048
1004312,29866,6180,87617,18431,142094
1004313,85570,85246,53525,31542,255883
1004314,14458,63909,6131,46585,131083
1004315,74573,369,29175,25920,130037
1004316,25343,82170,27629,57472,192614
1004317,80752,20317,62238,64063,227370
1004318,71857,51324,59206,75391,257778
1004319,77525,47168,86759,46597,258049
1004320,366,89572,88824,2740,181502
1004321,82377,61136,15822,20689,180024
1004322,80244,85335,63949,51722,281250
1004323,39120,54036,70048,91569,254773
1004324,97025,85185,55276,5402,242888
1004325,88625,23550,56589,23318,192082
1004326,17300,72024,51252,18565,159141
1004327,93083,83978,86073,2806,265940
1004328,81373,32717,81739,66057,261886
1004329,51920,71067,47171,33748,203906
1004330,34266,46495,68788,76097,225646
1004331,76105,44666,36365,85551,242687
1004332,2872,95094,25495,73601,197062
1004333,43269,69823,88313,27390,228795
1004334,27923,19454,24320,32817,104514
1004335,22525,5530,42067,57775,127897
1004336,58305,63179,36454,90361,248299
1004337,87895,51636,45908,64263,249702
1004338,20073,87029,6345,46863,160310
1004339,51339,23665,11947,37035,123986
1004340,81639,97151,59287,14463,252540
1004341,98044,17252,23846,66903,206045
1004342,33350,45356,52229,88908,219843
1004343,17844,70075,58808,32060,178787
1004344,22502,98807,62143,47083,230535
1004345,64337,4479,24132,18646,111594
1004346,74333,29501,9615,21949,135398
1004347,52992,73278,47425,26660,200355
1004348,79952,78751,75021,8820,242544
1004349,41006,23368,62000,97197,223571
1004350,28092,83696,51766,50240,213794
1004351,63560,43062,95149,33242,235013
1004352,80156,35884,29905,62561,208506
1004353,52316,42531,72016,36946,203809
1004354,95063,78923,90017,92922,356925
1004355,52887,42333,91038,93339,279597
1004356,89126,56655,90812,66750,303343
1004357,44321,68058,99095,56983,268457
1004358,48418,7307,43817,93866,193408
1004359,76046,28547,2386,29135,136114
1004360,74901,65477,45629,43291,229298
1004361,74872,30866,70243,57474,233455
1004362,25831,38896,47001,8304,120032
1004363,94471,34049,63690,44597,236807
1004364,28484,88413,42438,1447,160782
1004365,8640,70885,37343,12336,129204
1004366,3217,27831,70123,8524,109695
1004367,27889,64672,33663,12041,138265
1004368,78266,40132,65193,36744,220335
1004369,85012,97227,44697,89868,316804
1004370,94009,61995,91025,80189,327218
1004371,35801,47788,33895,8865,126349
1004372,38240,71089,47547,72130,229006
1004373,86099,87010,2729,24244,200082
1004374,7328,49376,4557,98693,159954
1004375,8762,67205,45892,63778,185637
1004376,43534,27330,56946,82556,210366
1004377,81525,97416,54638,52228,285807
1004378,82667,32992,428,43275,159362
1004379,15765,55774,12354,70500,154393
1004380,2384,80192,6199,74005,162780
1004381,58293,42220,24879,24585,149977
1004382,43513,28190,69454,29419,170576
1004383,17424,80879,7606,2150,108059
1004384,40485,71447,82390,2121,196443
1004385,82070,17750,79821,39064,218705
1004386,79262,23747,80200,12463,195672
1004387,1061,90168,71838,82391,245458
1004388,76412,67360,90977,98091,332840
1004389,42368,46458,93882,34021,216729
1004390,98785,69106,81144,40298,289333
1004391,20366,31040,43943,95167,190516
1004392,46506,40381,77555,56897,221339
1004393,4990,83143,45159,21344,154636
1004394,85583,55989,3758,47339,192669
1004395,68316,12950,37106,86621,204993
1004396,31575,73680,50856,45496,201607
1004397,43495,51647,47547,521,143210
1004398,26128,5884,20415,64723,117150
1004399,40682,82039,31461,3500,157682
1004400,54657,4422,15212,46483,120774
1004401,17506,2211,41468,58256,119441
1004402,38841,32680,95322,13011,179854
1004403,62525,85991,92586,45820,286922
1004404,72857,73426,36397,65031,247711
1004405,2617,47446,36672,1954,88689
1004406,2518,59106,52103,29142,142869
1004407,84768,90099,91538,99104,365509
1004408,79794,34644,56479,29274,200191
1004409,90124,2539,89625,22891,205179
1004410,97143,94365,12284,54821,258613
1004411,31735,84409,13681,80951,210776
1004412,15261,64315,55770,87570,222916
1004413,49675,94907,98024,7249,249855
1004414,54481,23588,98759,50768,227596
1004415,78081,74502,61486,53003,267072
1004416,99428,92614,14740,36694,243476
1004417,75996,38529,57993,80898,253416
1004418,96454,29557,28935,35022,189968
1004419,33821,59510,47261,70712,211304
1004420,13181,70783,19832,45738,149534
1004421,66873,15062,61428,76907,220270
1004422,22204,51416,82238,62291,218149
1004423,26812,16816,75096,1073,119797
1004424,67347,52936,20315,43938,184536
1004425,34557,902,1469,79497,116425
1004426,40707,51382,43997,6281,142367
1004427,12622,34763,27965,48786,124136
1004428,57558,98941,38860,31958,227317
1004429,80103,27593,50792,14630,173118
1004430,47583,21621,57398,24362,150964
1004431,31436,7373,22483,60558,121850
1004432,83961,69214,49169,79543,281887
1004433,14742,96620,82763,85097,279222
1004434,25808,80916,78691,22599,208014
1004435,14895,26970,84529,74106,200500
1004436,80745,39476,73636,93449,287306
1004437,33592,50891,99974,57115,241572
1004438,7907,59364,5875,46794,119940
1004439,82091,54283,7779,27848,172001
1004440,88796,34691,77619,88575,289681
1004441,6450,71155,85073,66467,229145
1004442,40520,70528,72158,57035,240241
1004443,2237,8971,85890,60011,157109
1004444,76280,30316,78645,81893,267134
1004445,24841,76225,58258,42368,201692
1004446,87384,53239,38653,22502,201778
1004447,55406,43970,34976,51545,185897
1004448,66390,84934,29808,49948,231080
1004449,26017,56154,59700,65835,207706
1004450,4468,5696,95306,19555,125025
1004451,47883,79807,73703,42623,244016
1004452,5746,10165,39881,96197,151989
1004453,19897,55374,84721,89754,249746
1004454,71508,84381,62691,70383,288963
1004455,62604,99396,94055,6992,263047
1004456,18270,44468,52415,46866,162019
1004457,55357,87961,42531,39992,225841
1004458,7331,70976,23197,16165,117669
1004459,18382,85057,42827,81472,227738
1004460,21680,878,32746,77757,133061
1004461,11774,74132,12809,53654,152369
1004462,99404,59193,92606,47383,298586
1004463,36296,5419,14472,70127,126314
1004464,41836,45278,69951,63345,220410
1004465,55748,55212,66722,75594,253276
1004466,38903,45084,29556,15730,129273
1004467,86743,91047,38144,96608,312542
1004468,85601,94304,42488,90428,312821
1004469,94407,8214,62445,47950,213016
1004470,32105,10113,62807,87210,192235
1004471,93113,87243,69002,94695,344053
1004472,66457,39511,69430,49217,224615
1004473,34673,72619,32225,48592,188109
1004474,25945,72305,14772,97233,210255
1004475,69903,12041,42839,22007,146790
1004476,39034,4577,65615,10580,119806
1004477,97359,28836,23041,64620,213856
1004478,86973,35211,9148,79651,210983
1004479,22697,3019,50800,40967,117483
1004480,4977,91338,10428,83206,189949
1004481,55634,94509,94927,76675,321745
1004482,88280,94878,1366,45476,230000
1004483,96466,99962,43540,29252,269220
1004484,17822,73773,63481,74877,229953
1004485,97829,38668,26366,30003,192866
1004486,93039,32217,55865,82777,263898
1004487,32356,69541,73484,93760,269141
1004488,439,561,52899,69641,123540
1004489,57068,54060,50623,28216,189967
1004490,82919,548,56472,38823,178762
1004491,95270,92497,99453,6025,293245
1004492,94037,45991,22878,74548,237454
1004493,30502,43501,59507,78466,211976
1004494,66767,75380,44334,23282,209763
1004495,82728,18921,47034,95757,244440
1004496,73080,60705,62236,92428,288449
1004497,75156,49764,20188,76584,221692
1004498,57241,15134,84519,86515,243409
1004499,63120,3046,92556,90889,249611
1004500,70449,19160,19023,16404,125036
1004501,82957,97662,45683,22677,248979
1004502,55344,29883,12591,67700,165518
1004503,50507,64719,21521,14786,151533
1004504,67926,18423,24460,20449,131258
1004505,55080,33293,57831,13642,159846
1004506,29095,41047,22263,73312,165717
1004507,41111,91518,20118,50652,203399
1004508,86382,55843,87252,31188,260665
1004509,77661,79916,12272,60113,229962
1004510,10053,45235,77037,72130,204455
1004511,5554,36379,46582,29041,117556
1004512,15576,94037,28210,72603,210426
1004513,25048,48170,59548,52369,185135
1004514,9833,26464,77713,92163,206173
1004515,31500,58557,86255,66687,242999
1004516,90299,62035,75960,14519,242813
1004517,22771,65242,88864,3151,180028
1004518,614,88174,28216,17476,134480
1004519,81603,68522,99103,98700,347928
1004520,32948,87941,29457,78185,228531
1004521,49298,88128,83116,94431,314973
1004522,68431,62200,82809,39594,253034
1004523,51060,94522,5179,28703,179464
1004524,67639,95047,32088,81108,275882
1004525,60458,34180,41006,15590,151234
1004526,3412,93437,92480,65795,255124
1004527,388,13842,21287,49092,84609
1004528,59638,67914,86509,4410,218471
1004529,67407,54913,55573,55825,233718
1004530,73941,55615,13053,58877,201486
1004531,63373,3024,75627,90958,232982
1004532,328,46013,16107,11394,73842
1004533,24367,23516,98065,83816,229764
1004534,42705,14376,2871,48692,108644
1004535,74776,24378,86934,36073,222161
1004536,65044,21131,56204,56745,199124
1004537,36955,4217,95314,55630,192116
1004538,64758,53387,6949,63146,188240
1004539,87039,58916,53205,98844,298004
1004540,32262,11241,57502,19311,120316
1004541,19044,7157,61977,90901,179079
1004542,68142,25220,615,11885,105862
1004543,63738,99720,31277,3742,198477
1004544,2439,13910,2673,46176,65198
1004545,68880,56329,24522,17020,166751
1004546,2161,91664,8994,63070,165889
1004547,26407,90595,42410,3287,162699
1004548,99021,94079,98756,9197,301053
1004549,7954,55453,23127,86882,173416
1004550,340,16382,22159,68184,107065
1004551,22415,29292,85638,42026,179371
1004552,34095,20171,51679,4854,110799
1004553,74332,12055,70997,8115,165499
1004554,21626,70511,7803,42745,142685
1004555,39194,74045,11463,12990,137692
1004556,36418,25114,63150,93858,218540
1004557,22154,36857,79149,63375,201535
1004558,37663,76068,20922,94768,229421
1004559,56697,98516,81654,40305,277172
1004560,34339,68966,29562,85757,218624
1004561,79423,57009,76086,80684,293202
1004562,98332,57837,94423,99276,349868
1004563,87595,2165,27761,52144,169665
1004564,10591,90495,50691,69526,221303
1004565,97784,25717,19196,37379,180076
1004566,93644,2695,20981,85487,202807
1004567,50729,64735,19428,64366,199258
1004568,43874,68674,25945,74495,212988
1004569,29092,45147,94086,58497,226822
1004570,67707,81237,8617,48931,206492
1004571,44189,92804,76735,9576,223304
1004572,84452,57391,26920,96050,264813
1004573,68575,79809,80639,98138,327161
1004574,89315,15494,25022,22979,152810
1004575,95752,92971,19513,63942,272178
1004576,24670,84395,33924,45238,188227
1004577,10134,76638,20601,25625,132998
1004578,17100,95655,53131,68201,234087
1004579,90770,20622,28049,88789,228230
1004580,55390,40390,80535,73373,249688
1004581,58939,20853,73535,27532,180859
1004582,40076,74996,24597,95402,235071
1004583,20360,66899,52764,31512,171535
1004584,93422,92242,99304,28486,313454
1004585,97996,46240,81613,48211,274060
1004586,30858,62043,36553,94728,224182
1004587,41544,43726,65754,37565,188589
1004588,94142,93409,33406,94408,315365
1004589,86077,56754,9300,62962,215093
1004590,4034,25888,74754,30617,135293
1004591,39297,65254,11861,59705,176117
1004592,51681,57153,21069,36919,166822
1004593,54921,77355,72019,10451,214746
1004594,40016,92643,596,95297,228552
1004595,75955,23996,51075,64435,215461
1004596,1760,40650,10074,32857,85341
1004597,12916,35052,16624,73668,138260
1004598,56678,33314,34377,52564,176933
1004599,37731,81012,90850,10741,220334
1004600,57372,41791,5963,63016,168142
1004601,81485,78454,61960,80976,302875
1004602,75466,12979,19015,12030,119490
1004603,22649,68056,76167,95742,262614
1004604,31170,40608,69154,16218,157150
1004605,51560,5763,50391,34801,142515
1004606,27743,79010,32728,70295,209776
1004607,22350,79697,24966,27754,154767
1004608,25275,10207,22631,25520,83633
1004609,88652,5062,30527,61289,185530
1004610,59412,55543,66305,60526,241786
1004611,77954,12837,7098,24702,122591
1004612,73409,75009,36473,32871,217762
1004613,96789,40802,78816,71362,287769
1004614,67138,46893,71492,38565,224088
1004615,22293,39301,22812,9854,94260
1004616,67528,96698,93229,86882,344337
1004617,87924,16167,55851,60039,219981
1004618,53912,57851,36530,10044,158337
1004619,25346,92345,88484,42893,249068
1004620,13159,47176,17280,95998,173613
1004621,20878,19898,8442,39134,88352
1004622,74576,6013,29987,90510,201086
1004623,32071,80969,68668,57577,239285
1004624,22788,55789,16638,1741,96956
1004625,38569,36778,80371,5783,161501
1004626,88455,80044,75804,51137,295440
1004627,4171,5419,45851,18083,73524
1004628,68894,80445,76578,56980,282897
1004629,98652,23318,46176,66935,235081
1004630,80452,11818,40321,39318,171909
1004631,63038,85404,76055,31563,256060
1004632,50682,99606,98546,31083,279917
1004633,16150,57228,80882,5353,159613
1004634,259,74532,9888,68412,153091
1004635,67091,53754,11980,12350,145175
1004636,53787,35488,32323,73471,195069
1004637,88529,81430,79936,45250,295145
1004638,19831,60037,77026,75763,232657
1004639,89012,78880,6256,76405,250553
1004640,91782,58937,31432,68116,250267
1004641,75880,43954,21698,72095,213627
1004642,46803,99533,56561,2337,205234
1004643,53665,2465,23680,72493,152303
1004644,81740,54009,58367,54662,248778
1004645,49638,40076,25859,76747,192320
1004646,78369,28455,85437,31628,223889
1004647,45102,28036,69981,74888,218007
1004648,48655,74284,47192,78705,248836
1004649,93024,49571,1527,6702,150824
1004650,55707,27646,94279,34897,212529
1004651,41303,62296,91188,82821,277608
1004652,1180,60740,47502,97052,206474
1004653,37821,23680,37338,28728,127567
1004654,94940,97033,3853,82307,278133
1004655,58037,47898,40459,59909,206303
1004656,46601,10011,94548,48131,199291
1004657,69287,1067,77330,90205,237889
1004658,40914,66155,71642,24099,202810
1004659,30991,78351,21668,45119,176129
1004660,31582,2847,73121,33570,141120
1004661,64327,28133,7316,88398,188174
1004662,16646,62469,84998,16405,180518
1004663,96039,95873,67053,24854,283819
1004664,33785,20642,63338,63311,181076
1004665,45387,16515,32967,80423,175292
1004666,30890,4700,92907,81463,209960
1004667,52129,41599,12971,88646,195345
1004668,87743,74651,44118,74811,281323
1004669,94488,80255,34405,6108,215256
1004670,60230,74919,41088,80000,256237
1004671,46869,31268,25946,63898,167981
1004672,7675,12499,57142,51621,128937
1004673,68092,57661,12595,79195,217543
1004674,36518,12645,49303,69192,167658
1004675,10471,58436,44256,17298,130461
1004676,75633,87410,98719,56458,318220
1004677,74224,53188,54946,87960,270318
1004678,3770,14167,88147,87459,193543
1004679,14293,55090,43678,70791,183852
1004680,33288,58766,20261,9253,121568
1004681,60734,71428,36682,78270,247114
1004682,12189,14472,95125,54683,176469
1004683,45161,60134,72290,63251,240836
1004684,12102,25972,68776,39524,146374
1004685,61022,28723,60,52565,142370
1004686,95122,31086,59808,15842,201858
1004687,76745,50218,78475,14501,219939
1004688,84248,94316,65641,68477,312682
1004689,60709,1661,6918,14871,84159
1004690,35376,1844,52387,22090,111697
1004691,21681,81049,99899,973,203602
1004692,47276,67885,39238,62433,216832
1004693,3953,1181,83332,33121,121587
1004694,8112,38904,96040,40006,183062
1004695,15062,4863,19271,4236,43432
1004696,50322,8789,74200,37151,170462
1004697,32065,85609,29228,32638,179540
1004698,42024,45675,7886,10561,106146
1004699,66017,25024,69464,63895,224400
1004700,93778,44118,58290,796,196982
1004701,93712,73326,37316,7075,211429
1004702,52398,91055,8494,81439,233386
1004703,86387,23994,54098,43257,207736
1004704,4934,58816,66936,31809,162495
1004705,47028,37959,81464,73839,240290
1004706,41109,68825,38722,68691,217347
1004707,12796,51488,64309,96404,224997
1004708,82303,49475,31876,62908,226562
1004709,17889,50298,83462,68031,219680
1004710,95700,79719,13836,99041,288296
1004711,62845,76852,71315,64287,275299
1004712,2966,41043,5315,67066,116390
1004713,69773,83807,17154,47523,218257
1004714,72345,38960,21911,68820,202036
1004715,61545,131,82523,51643,195842
1004716,41486,15582,85120,98257,240445
1004717,42401,87877,84313,70825,285416
1004718,33704,31485,51959,81324,198472
1004719,88686,56100,50000,66967,261753
1004720,92658,17836,69186,11628,191308
1004721,88262,64278,50617,81449,284606
1004722,68471,77452,9076,14969,169968
1004723,3637,6557,74191,13290,97675
1004724,20691,26818,19249,60532,127290
1004725,64528,44964,81464,78951,269907
1004726,20187,45679,52066,23203,141135
1004727,42153,39438,86835,97110,265536
1004728,15763,15165,12601,25172,68701
1004729,54098,53487,57236,57279,222100
1004730,53942,58438,61988,3984,178352
1004731,76053,97101,83963,14013,271130
1004732,14368,74749,83051,20709,192877
1004733,23055,45765,22751,38684,130255
1004734,62362,89623,55501,29152,236638
1004735,67808,26389,31591,47764,173552
1004736,24107,6170,16006,61656,107939
1004737,46977,31396,36698,28141,143212
1004738,22666,19282,4487,80519,126954
1004739,71523,79197,48471,15551,214742
1004740,53527,88721,13937,77377,233562
1004741,64498,7325,9848,94336,176007
1004742,10267,96476,72882,87900,267525
1004743,40181,4055,48028,21130,113394
1004744,35201,84475,75301,36102,231079
1004745,56055,99927,51304,39381,246667
1004746,53601,26155,5363,73066,158185
1004747,72193,79509,24409,48897,225008
1004748,91522,83852,85307,30759,291440
1004749,68268,75080,99955,47489,290792
1004750,10760,17731,26806,87493,142790
1004751,44741,43963,79182,30556,198442
1004752,56943,30564,57961,8783,154251
1004753,33133,14581,77337,65579,190630
1004754,7505,92948,42532,99489,242474
1004755,62305,87729,59110,47701,256845
1004756,93633,70559,60826,53792,278810
1004757,24135,47662,5482,1872,79151
1004758,87380,89994,39456,61649,278479
1004759,75935,58172,29378,13884,177369
1004760,25556,56164,20649,5323,107692
1004761,80869,28420,43094,9665,162048
1004762,23438,40502,87442,95512,246894
1004763,44928,80170,74987,10650,210735
1004764,64266,90475,50624,88859,294224
1004765,79394,974,21761,78482,180611
1004766,40808,93784,39811,61742,236145
1004767,23670,91562,94352,60198,269782
1004768,14301,37902,68552,9678,130433
1004769,80005,32585,65815,13594,191999
1004770,54296,21940,88034,45103,209373
1004771,7548,41553,93652,15765,158518
1004772,70922,49890,48659,87401,256872
1004773,96847,36132,59658,58908,251545
1004774,35570,28541,78034,31226,173371
1004775,79943,37239,16651,64019,197852
1004776,82558,28480,23259,72140,206437
1004777,5110,4488,4844,90884,105326
1004778,48551,10452,50337,21354,130694
1004779,89724,30782,28133,44487,193126
1004780,86716,21015,15076,84386,207193
1004781,30404,36019,66538,16547,149508
1004782,55884,69159,93952,37120,256115
1004783,48393,83537,36946,31741,200617
1004784,9866,66593,68368,99428,244255
1004785,76921,6474,38163,62005,183563
1004786,94491,99231,78346,53000,325068
1004787,14022,92256,96853,82834,285965
1004788,28305,51353,42795,43055,165508
1004789,92357,57665,20272,19778,190072
1004790,92408,49503,40304,87208,269423
1004791,43266,59523,20989,22504,146282
1004792,19092,3135,4485,73503,100215
1004793,88013,77298,29244,41494,236049
1004794,23862,34195,63902,90153,212112
1004795,62234,26170,11211,55269,154884
1004796,72508,44686,97054,14776,229024
1004797,33098,36949,60686,10780,141513
1004798,58258,13893,33976,76924,183051
1004799,14018,20154,37560,53222,124954
1004800,45044,36324,24671,90322,196361
1004801,40458,46647,75473,42920,205498
1004802,58903,53749,43581,19321,175554
1004803,14603,14450,17068,92760,138881
1004804,96741,99575,7289,94554,298159
1004805,11026,72247,39697,15724,138694
1004806,21694,74352,64447,5491,165984
1004807,66001,15738,12590,83031,177360
1004808,52974,88625,55026,88402,285027
1004809,79560,15530,88877,70392,254359
1004810,57271,65890,20730,56021,199912
1004811,56513,13427,99568,44260,213768
1004812,31327,20332,22950,71053,145662
1004813,60070,44749,8420,32253,145492
1004814,20373,62686,32018,96559,211636
1004815,32526,243,78154,39098,150021
1004816,97615,11325,70889,11363,191192
1004817,66736,20863,60968,63178,211745
1004818,30973,20693,69797,94463,215926
1004819,9591,8359,34054,57392,109396
1004820,34555,27563,62435,88751,213304
1004821,37904,68698,43627,20972,171201
1004822,21326,73487,88965,24769,208547
1004823,84435,48717,18554,73698,225404
1004824,59962,74183,95813,89808,319766
1004825,19616,90365,76382,89782,276145
1004826,95919,8445,89898,55251,249513
1004827,49834,19018,53303,39510,161665
1004828,96658,21208,64471,27321,209658
1004829,25404,59294,53234,89585,227517
1004830,39534,92142,27553,28639,187868
1004831,1582,21920,10021,21149,54672
1004832,48585,20666,9178,44605,123034
1004833,91147,40331,90376,87933,309787
1004834,35759,1342,96580,64509,198190
1004835,609,37697,64648,61255,164209
1004836,54298,23814,83756,66788,228656
1004837,90311,2722,56348,68165,217546
1004838,95740,26402,61265,27462,210869
1004839,60299,44263,29383,86510,220455
1004840,54071,22435,52907,92021,221434
1004841,6387,44482,23300,57426,131595
1004842,93006,19430,17330,15033,144799
1004843,95044,27561,84731,7384,214720
1004844,60960,18179,77359,32736,189234
1004845,61095,61146,14160,7596,143997
1004846,41992,3241,10494,82723,138450
1004847,75601,402,22934,74160,173097
1004848,95646,19238,79065,4786,198735
1004849,21620,20123,15616,52052,109411
1004850,5121,27270,92870,64575,189836
1004851,28163,90077,53329,70282,241851
1004852,87464,82171,23823,27009,220467
1004853,71939,2608,221,91180,165948
1004854,27108,95087,63632,36671,222498
1004855,49934,12611,49064,66074,177683
1004856,23035,6046,14562,8706,52349
1004857,23028,46705,54321,41805,165859
1004858,54743,19362,19858,13930,107893
1004859,23371,75400,13519,74037,186327
1004860,18737,88582,71529,98254,277102
1004861,12839,14666,5165,36534,69204
1004862,32196,68684,77094,29238,207212
1004863,18075,79955,53535,55125,206690
1004864,67640,18328,84058,86551,256577
1004865,65384,34053,12701,418,112556
1004866,4264,95415,45658,63462,208799
1004867,9396,94397,85037,53262,242092
1004868,2039,1293,20934,45713,69979
1004869,54519,94150,9560,59097,217326
1004870,20100,52818,87156,33264,193338
1004871,51723,92747,31016,80529,256015
1004872,47073,70347,58340,10815,186575
1004873,89443,83989,72148,59471,305051
1004874,16130,81256,61506,93956,252848
1004875,4054,52470,35169,16922,108615
1004876,64700,3051,90990,89039,247780
1004877,6677,93350,88705,3924,192656
1004878,87774,19998,56852,57937,222561
1004879,70828,45527,22550,35100,174005
1004880,37922,54586,82821,72897,248226
1004881,95211,10653,97464,56806,260134
1004882,6206,69025,67577,79443,222251
1004883,54810,15424,95966,65001,231201
1004884,71088,10415,47877,37962,167342
1004885,23671,75689,53787,52643,205790
1004886,2129,12029,63344,14572,92074
1004887,45456,46479,56313,63654,211902
1004888,3439,52852,57526,46532,160349
1004889,42567,35045,37504,89347,204463
1004890,31067,43789,66205,64046,205107
1004891,66023,34967,30761,33216,164967
1004892,72388,76914,93947,85733,328982
1004893,21277,37359,92053,6902,157591
1004894,76245,52626,45573,34046,208490
1004895,68502,89813,51406,43864,253585
1004896,49015,13807,24230,16889,103941
1004897,66700,73322,91334,47304,278660
1004898,39626,63812,62328,14496,180262
1004899,82801,56963,93937,44813,278514
1004900,21124,57526,68508,44755,191913
1004901,47353,94714,54494,83755,280316
1004902,69630,73075,38583,35966,217254
1004903,28179,17114,8139,32,53464
1004904,26904,1086,21125,49245,98360
1004905,66588,71265,74451,11739,224043
1004906,95864,6190,93085,79679,274818
1004907,28103,32954,46488,35013,142558
1004908,36661,88277,70198,2857,197993
1004909,55398,16814,49699,44702,166613
1004910,97537,68994,89620,78844,334995
1004911,98132,39597,19168,71703,228600
1004912,66118,48655,45780,94752,255305
1004913,74382,30082,97617,85351,287432
1004914,79978,79041,29016,24638,212673
1004915,83903,26183,81514,95754,287354
1004916,98219,66665,87389,29434,281707
1004917,24299,42954,23868,4202,95323
1004918,71296,32998,52859,67836,224989
1004919,3119,960,80762,23046,107887
1004920,73843,92445,82007,15453,263748
1004921,17963,19675,52000,72897,162535
1004922,80556,27120,24690,95893,228259
1004923,86043,52408,82003,95744,316198
1004924,69265,73908,36318,80589,260080
1004925,11360,5441,50747,10089,77637
1004926,61190,26102,48910,34816,171018
1004927,17171,7918,12159,6192,43440
1004928,49847,66827,50733,93064,260471
1004929,52789,31273,33662,78928,196652
1004930,75300,23769,99229,47435,245733
1004931,76145,64539,50124,52203,243011
1004932,84237,52742,79241,66584,282804
1004933,60453,54265,5786,25143,145647
1004934,13284,71158,10526,37190,132158
1004935,54870,56523,82493,35201,229087
1004936,15134,93918,79773,92588,281413
1004937,94129,39070,80266,4126,217591
1004938,94894,68702,80057,87256,330909
1004939,32944,73715,56437,41523,204619
1004940,55029,54801,5326,30931,146087
1004941,57217,20589,83336,51964,213106
1004942,81972,14659,82693,21554,200878
1004943,15623,46386,33605,53104,148718
1004944,54759,44034,98668,58599,256060
1004945,53052,42740,87878,97430,281100
1004946,10511,66908,21355,40395,139169
1004947,68185,99154,15929,91501,274769
1004948,31149,30517,89167,90499,241332
1004949,92587,42100,32947,19396,187030
1004950,44938,95128,89263,66614,295943
1004951,95176,97573,86835,97411,376995
1004952,8207,4129,95454,19828,127618
1004953,10666,17278,55343,56511,139798
1004954,71865,87498,14751,93858,267972
1004955,23367,44231,61584,5658,134840
1004956,86201,20064,74524,17294,198083
1004957,96830,48639,75592,56322,277383
1004958,18227,78049,51248,47403,194927
1004959,41586,53442,63854,12438,171320
1004960,21686,28637,88740,87122,226185
1004961,51748,23240,12846,99965,187799
1004962,80077,8934,90651,37419,217081
1004963,26952,63411,12515,31002,133880
1004964,93523,13470,82470,1165,190628
1004965,407,2639,69760,64817,137623
1004966,86161,66332,38885,24744,216122
1004967,5181,89858,12774,11171,118984
1004968,62289,65638,60434,93693,282054
1004969,36394,8953,35829,98926,180102
1004970,28287,64300,9217,56149,157953
1004971,63109,19537,69230,33947,185823
1004972,2286,36871,21031,27631,87819
1004973,30896,26769,88483,19673,165821
1004974,20945,82412,54351,62168,219876
1004975,3202,46034,21699,14254,85189
1004976,62762,14782,91018,42824,211386
1004977,35512,22483,99320,35141,192456
1004978,46298,99891,69374,31613,247176
1004979,72343,53357,9894,33583,169177
1004980,67067,17878,79185,46780,210910
1004981,17252,84861,15593,61126,178832
1004982,68471,78983,98719,29844,276017
1004983,49056,58265,83416,40025,230762
1004984,4814,80253,31039,44166,160272
1004985,50313,56493,85308,1584,193698
1004986,81641,30516,46387,74018,232562
1004987,17087,66979,64124,23114,171304
1004988,51040,68828,7820,1838,129526
1004989,32589,16856,63611,46878,159934
1004990,70067,71711,19520,14370,175668
1004991,3777,12885,72484,54918,144064
1004992,54410,67507,82058,61255,265230
1004993,50371,77674,93758,44325,266128
1004994,37184,44094,11604,68215,161097
1004995,31229,83444,36147,19834,170654
1004996,24813,3452,92886,74431,195582
1004997,15340,33510,76483,44060,169393
1004998,71991,49206,66085,59212,246494
1004999,60682,26921,40754,45767,174124
1005000,33063,69276,57360,16807,176506
1005001,86379,8589,13673,72,108713
1005002,3022,47848,13447,28278,92595
1005003,7459,17714,83198,36103,144474
1005004,10354,81397,84733,3192,179676
1005005,81731,62844,75486,3358,223419
1005006,14594,69971,54626,15959,155150
1005007,96019,50114,97949,12953,257035
1005008,97294,64593,72376,1644,235907
1005009,46843,44070,65158,91295,247366
1005010,54542,42107,3370,8419,108438
1005011,29847,88676,17153,98487,234163
1005012,5207,64198,45981,28783,144169
1005013,62182,29467,61739,81770,235158
1005014,14933,91787,725,56939,164384
1005015,31645,3780,98615,46909,180949
1005016,49088,70315,3739,45673,168815
1005017,33508,64678,29498,98422,226106
1005018,4065,90240,88487,22435,205227
1005019,85593,40722,95371,74004,295690
1005020,62744,41761,37522,11825,153852
1005021,37337,70119,43332,26326,177114
1005022,25823,98261,25717,58756,208557
1005023,20429,93427,35488,90721,240065
1005024,67583,95344,237,95568,258732
1005025,81578,15862,86168,47788,231396
1005026,77916,47882,76800,14402,217000
1005027,48901,7840,88872,50849,196462
1005028,56149,12316,7502,51489,127456
1005029,27425,49334,14502,1603,92864
1005030,63403,84478,97225,61249,306355
1005031,33813,4987,69677,7382,115859
1005032,24601,17831,7211,70901,120544
1005033,91596,14767,25010,82977,214350
1005034,459,26623,3537,82249,112868
1005035,89983,568,95662,35257,221470
1005036,51742,74580,84303,6825,217450
1005037,93879,28318,66256,9740,198193
1005038,46992,246,97426,67975,212639
1005039,319,98673,82298,7614,188904
1005040,94373,33838,86227,20194,234632
1005041,65091,73754,96996,60904,296745
1005042,15109,87169,57189,31209,190676
1005043,62117,78113,2594,80121,222945
1005044,24158,66276,51394,88338,230166
1005045,48159,89955,31606,65882,235602
1005046,95804,7280,7291,60394,170769
1005047,83917,12723,98679,51225,246544
1005048,29517,18881,80390,10999,139787
1005049,45138,73885,78156,42751,239930
1005050,30677,34487,60068,95513,220745
1005051,9270,16597,64307,13151,103325
1005052,88395,51386,72431,89944,302156
1005053,50445,82180,39494,63798,235917
1005054,44761,82942,68465,36211,232379
1005055,20467,52675,21426,88452,183020
1005056,78745,21972,86475,26112,213304
1005057,74368,23998,42632,44519,185517
1005058,58318,30272,60137,77643,226370
1005059,27935,31355,74714,95475,229479
1005060,78195,11767,63456,1698,155116
1005061,82622,82864,23879,23159,212524
1005062,93334,71118,20322,50710,235484
1005063,70715,22698,25396,84198,203007
1005064,37064,5692,9103,1657,53516
1005065,56519,25317,91623,56158,229617
1005066,82201,15007,94222,31718,223148
1005067,63971,81869,17521,62742,226103
1005068,79961,87726,85927,33078,286692
1005069,47007,91097,37747,6366,182217
1005070,5675,93709,61720,4263,165367
1005071,80367,9783,58244,44989,193383
1005072,56566,47303,38107,6878,148854
1005073,21354,64034,22251,49304,156943
1005074,28880,19591,92450,28498,169419
1005075,58870,23381,1909,71113,155273
1005076,74387,59625,91664,12442,238118
1005077,85668,53881,91560,36655,267764
1005078,69472,47668,34637,50251,202028
1005079,98554,71367,99973,36356,306250
1005080,43261,32820,24077,17625,117783
1005081,4204,87786,94239,77745,263974
1005082,43452,78935,95142,37627,255156
1005083,43491,24115,2762,2692,73060
1005084,84818,51277,56378,60236,252709
1005085,58177,48556,51828,58058,216619
1005086,67374,56579,27042,63987,214982
1005087,85197,63987,89772,23848,262804
1005088,44674,53400,53847,17737,169658
1005089,17934,5336,95087,87979,206336
1005090,29291,18160,98099,645,146195
1005091,1794,2576,3929,43462,51761
1005092,9338,5347,20963,81137,116785
1005093,26673,9007,54233,63578,153491
1005094,87368,93356,2745,2597,186066
1005095,60589,77425,47985,87166,273165
1005096,11575,32986,50895,2257,97713
1005097,66383,59229,39049,57141,221802
1005098,75364,29889,81598,81235,268086
1005099,74211,20787,91128,4264,190390
1005100,96796,11558,10412,26298,145064
1005101,95975,64074,23654,89720,273423
1005102,52618,74528,93202,57468,277816
1005103,58077,4344,37739,71351,171511
1005104,15746,68458,52197,5593,141994
1005105,91599,56476,39287,13445,200807
1005106,49627,97444,82610,28558,258239
1005107,54033,28625,59594,81282,223534
1005108,74648,59793,75468,60239,270148
1005109,7638,80362,96773,39541,224314
1005110,10021,84133,6520,59491,160165
1005111,57885,68626,29632,11267,167410
1005112,68715,98074,27552,95857,290198
1005113,13887,50214,15242,68339,147682
1005114,32200,92005,86481,75541,286227
1005115,52759,5917,44203,72269,175148
1005116,83679,25347,51651,27228,187905
1005117,92484,70357,7745,15658,186244
1005118,73450,41529,26392,25052,166423
1005119,65235,26772,42521,85264,219792
1005120,22499,74403,4966,83989,185857
1005121,75187,50123,75286,3461,204057
1005122,64764,39600,2539,25232,132135
1005123,8082,94384,23084,21716,147266
1005124,7217,57161,22354,64261,150993
1005125,2069,22075,58452,98066,180662
1005126,47578,5628,75581,7777,136564
1005127,72904,76334,94240,42626,286104
1005128,50851,38640,56375,10746,156612
1005129,44884,14843,46472,49910,156109
1005130,87264,53149,26401,83876,250690
1005131,15435,74614,16170,60554,166773
1005132,94659,56591,48398,9805,209453
1005133,4898,61984,21710,13297,101889
1005134,24173,26490,68211,76957,195831
1005135,82908,20574,74611,26679,204772
1005136,20093,51311,89374,8730,169508
1005137,65535,74462,31054,12035,183086
1005138,55898,5324,39251,17259,117732
1005139,14973,69146,87907,4474,176500
1005140,2482,99535,11015,84997,198029
1005141,53833,97760,34486,21832,207911
1005142,30910,44281,1815,33505,110511
1005143,88456,17995,32548,27947,166946
1005144,12222,19116,72230,18020,121588
1005145,79621,38908,79394,90978,288901
1005146,74737,8805,50123,87781,221446
1005147,88138,22993,63298,79237,253666
1005148,55884,1711,59026,82465,199086
1005149,5159,57292,80339,62283,205073
1005150,62739,18196,85906,62552,229393
1005151,51210,91059,47493,40551,230313
1005152,81370,65419,33106,16546,196441
1005153,45861,64548,24540,61037,195986
1005154,32893,73019,73631,18310,197853
1005155,67743,45313,92069,15178,220303
1005156,72714,43233,68241,58813,243001
1005157,66994,33416,55843,84042,240295
1005158,41404,25044,55832,15546,137826
1005159,3332,26345,41537,56103,127317
1005160,95765,80454,21217,30195,227631
1005161,45066,72270,21266,53753,192355
1005162,17827,7015,93500,16117,134459
1005163,13827,12555,62688,91034,180104
1005164,41672,55153,89093,82613,268531
1005165,17503,79,19990,33142,70714
1005166,95177,74794,41377,53898,265246
1005167,64867,44773,86836,78075,274551
1005168,85785,31018,13918,51390,182111
1005169,40033,50057,43320,3042,136452
1005170,46367,38288,89908,71772,246335
1005171,73045,13986,65080,31506,183617
1005172,35336,78390,77044,34258,225028
1005173,731,89336,50647,25173,165887
1005174,72155,44574,60421,83128,260278
1005175,11729,50261,93738,66360,222088
1005176,2229,43927,88632,35553,170341
1005177,3931,7233,14125,8269,33558
1005178,74495,11822,58579,54706,199602
1005179,5552,72154,57661,33627,168994
1005180,95421,50761,73269,15766,235217
1005181,36245,30079,19993,94761,181078
1005182,18568,69139,21093,17782,126582
1005183,52203,87602,73094,45248,258147
1005184,32728,70201,63741,84239,250909
1005185,77617,26495,35976,85945,226033
1005186,55020,68656,51123,51847,226646
1005187,21444,13021,72969,62717,170151
1005188,17483,85881,31990,84945,220299
1005189,79947,67212,96249,3660,247068
1005190,75638,68300,5234,85220,234392
1005191,33411,69670,73313,36422,212816
1005192,20650,59512,29723,3890,113775
1005193,55895,24791,43254,21080,145020
1005194,44521,50094,13707,79781,188103
1005195,92477,52077,72630,74652,291836
1005196,45266,16949,82037,49936,194188
1005197,20550,1043,10249,89235,121077
1005198,9613,85314,54554,79746,229227
1005199,78416,47608,33450,54037,213511
1005200,86001,71847,51623,36645,246116
1005201,60691,96988,41423,58874,257976
1005202,49521,40758,51733,52870,194882
1005203,9425,77548,50816,99961,237750
1005204,51214,60395,86262,94141,292012
1005205,45889,70728,66268,89992,272877
1005206,89936,25524,44331,61760,221551
1005207,50207,23450,73885,21109,168651
1005208,67022,15259,62037,49932,194250
1005209,98178,1460,89746,28101,217485
1005210,76525,20238,66302,82411,245476
1005211,73643,5689,47224,23155,149711
1005212,95222,91532,29304,3338,219396
1005213,75390,23545,38141,52249,189325
1005214,23571,94451,22881,77103,218006
1005215,98182,45148,71484,85177,299991
1005216,59695,19711,45260,73233,197899
1005217,48571,96555,29436,15525,190087
1005218,6257,51965,19176,76848,154246
1005219,39196,54671,89756,64974,248597
1005220,30964,37616,88513,40171,197264
1005221,18910,87555,86119,11545,204129
1005222,62088,34596,79559,74034,250277
1005223,78379,65155,74053,99389,316976
1005224,6112,32988,24441,97580,161121
1005225,53808,31990,56809,68382,210989
1005226,56198,60030,490,8789,125507
1005227,44584,67795,8625,57197,178201
1005228,13782,63765,47080,63642,188269
1005229,4830,71375,38218,37872,152295
1005230,84651,15331,11961,74652,186595
1005231,5745,29911,95672,37465,168793
1005232,7480,49303,94348,29526,180657
1005233,95436,20153,18179,262,134030
1005234,87944,77779,16339,10830,192892
1005235,20607,63084,49411,41082,174184
1005236,11334,57925,80854,91784,241897
1005237,12680,37250,97513,5,147448
1005238,45243,74483,16875,39596,176197
1005239,41469,64695,86047,78318,270529
1005240,33427,48371,7837,60286,149921
1005241,83829,17977,72437,35531,209774
1005242,64158,12288,93962,85294,255702
1005243,54582,44905,17960,95146,212593
1005244,74673,46179,11726,46889,179467
1005245,33778,73102,9639,71720,188239
1005246,5901,1895,98058,43138,148992
1005247,60533,14331,55600,80010,210474
1005248,68180,97678,41017,75742,282617
1005249,50907,99126,24846,73137,248016
1005250,28829,93480,85122,66165,273596
1005251,52634,39688,68958,48833,210113
1005252,58113,61322,21566,74680,215681
1005253,29488,55287,6654,20227,111656
1005254,92290,39471,33634,74103,239498
1005255,37659,88746,54465,18991,199861
1005256,2759,80852,70047,64879,218537
1005257,29516,49911,55484,87795,222706
1005258,56500,70260,98319,63033,288112
1005259,75564,60448,1841,81220,219073
1005260,94676,65410,22884,58108,241078
1005261,94345,42485,34745,94378,265953
1005262,76318,15557,19133,43370,154378
1005263,61883,41122,51661,69731,224397
1005264,23750,7596,65790,4609,101745
1005265,8467,31437,80586,57583,178073
1005266,4406,90108,82761,58199,235474
1005267,39122,52350,23989,17271,132732
1005268,88780,82008,42633,97306,310727
1005269,18834,30845,24492,2093,76264
1005270,47686,15090,7302,32779,102857
1005271,99959,77131,39522,41870,258482
1005272,78931,19972,27994,61317,188214
1005273,10479,23206,14266,96928,144879
1005274,60911,50557,84356,14722,210546
1005275,59021,36517,63367,13193,172098
1005276,62393,30457,89433,39899,222182
1005277,87595,90684,20851,75158,274288
1005278,49143,12719,41740,35857,139459
1005279,48406,90812,42816,50977,233011
1005280,2979,20928,48787,38324,111018
1005281,67890,68017,70680,69660,276247
1005282,38460,67410,37585,30068,173523
1005283,68767,81520,83520,34680,268487
1005284,8274,88603,71260,5581,173718
1005285,28106,52715,99638,15136,195595
1005286,96297,7629,68276,79126,251328
1005287,50282,76883,98405,94338,319908
1005288,33424,41872,45747,8009,129052
1005289,14229,69099,96641,60715,240684
1005290,86852,3840,82940,59557,233189
1005291,72759,24597,6272,1630,105258
1005292,62233,30202,24320,42661,159416
1005293,55533,60305,84327,71946,272111
1005294,95678,26574,92890,76403,291545
1005295,20014,66011,3608,44501,134134
1005296,98494,86533,84844,86450,356321
1005297,299,75739,14415,58807,149260
1005298,6686,47644,44932,22244,121506
1005299,1918,28556,999,15769,47242
1005300,82556,11506,94446,26833,215341
1005301,81170,80537,87543,67647,316897
1005302,47150,35038,94891,87232,264311
1005303,27893,88564,30361,9950,156768
1005304,21347,5673,30086,38046,95152
1005305,93354,89056,54000,86191,322601
1005306,10372,49118,17939,17944,95373
1005307,83090,98507,98607,87333,367537
1005308,86057,9988,19400,20926,136371
1005309,6950,51805,6211,56876,121842
1005310,82565,99602,84977,73268,340412
1005311,27382,60725,23794,63322,175223
1005312,22287,23496,18786,28939,93508
1005313,53136,80050,47420,65382,245988
1005314,27489,65532,49553,73658,216232
1005315,90690,50348,93113,91690,325841
1005316,69331,11965,80215,77896,239407
1005317,41830,75472,9678,15523,142503
1005318,90608,98411,12622,62084,263725
1005319,58963,66542,10863,41922,178290
1005320,8723,68527,85409,75774,238433
1005321,69445,65774,85485,86635,307339
1005322,82670,67646,3127,4946,158389
1005323,77329,62087,9294,66610,215320
1005324,62764,64663,92448,16445,236320
1005325,85751,8243,65234,3546,162774
1005326,19743,11300,55063,88416,174522
1005327,75158,72926,85083,45847,279014
1005328,94539,71568,64979,91755,322841
1005329,44867,53789,24961,16546,140163
1005330,9807,53282,70066,64117,197272
1005331,71576,3817,57036,17914,150343
1005332,30736,4378,82513,67629,185256
1005333,72780,99489,6197,85166,263632
1005334,26034,85589,69832,51631,233086
1005335,6384,7444,80202,74165,168195
1005336,26349,41025,71820,14151,153345
1005337,67958,29650,76053,61669,235330
1005338,96912,39376,50017,57057,243362
1005339,28973,21740,30575,50853,132141
1005340,87214,84220,45799,46471,263704
1005341,89656,4265,23463,99029,216413
1005342,87493,8619,92042,5497,193651
1005343,80437,16207,78564,12296,187504
1005344,12606,46590,86181,13394,158771
1005345,58337,29399,68349,32635,188720
1005346,45262,30282,56707,70648,202899
1005347,69549,52246,82789,39969,244553
1005348,42353,28198,78000,35169,183720
1005349,79229,24301,17216,2432,123178
1005350,3765,18003,12866,67093,101727
1005351,9693,68435,64853,3468,146449
1005352,87262,74921,61353,70585,294121
1005353,59393,4471,2271,19836,85971
1005354,47611,73317,34691,47174,202793
1005355,66289,42832,64197,62881,236199
1005356,83856,99097,37138,19418,239509
1005357,22415,8169,17162,33518,81264
1005358,6878,27933,35873,89797,160481
1005359,54624,11124,50869,56723,173340
1005360,45258,44831,72480,76800,239369
1005361,39290,62638,12601,10152,124681
1005362,69105,34875,39303,40110,183393
1005363,5824,92270,92474,41199,231767
1005364,66508,66638,41176,75568,249890
1005365,71838,75818,46692,69950,264298
1005366,34292,808,86402,1638,123140
1005367,38151,38500,61406,26480,164537
1005368,24978,36642,10784,87024,159428
1005369,52129,16458,35568,18161,122316
1005370,81075,17786,87100,78337,264298
1005371,64436,444,37793,38079,140752
1005372,77708,28887,6182,9919,122696
1005373,31346,19430,91028,25959,167763
1005374,56684,190,794,33904,91572
1005375,35163,71705,94835,95259,296962
1005376,75431,11356,9051,36567,132405
1005377,98877,82628,9414,2978,193897
1005378,43680,97821,98128,44194,283823
1005379,78833,6478,74998,58964,219273
1005380,62505,23889,3780,4947,95121
1005381,29077,15349,27299,48398,120123
1005382,56196,31397,73572,56733,217898
1005383,48194,70376,84620,29298,232488
1005384,87404,50720,57770,83072,278966
1005385,10194,47737,78674,52741,189346
1005386,13878,4159,50954,69209,138200
1005387,34439,40811,89253,75069,239572
1005388,5033,82983,52503,92620,233139
1005389,94330,29002,39043,85184,247559
1005390,76172,47754,47512,36626,208064
1005391,48161,34745,44200,74755,201861
1005392,45082,17455,34586,40260,137383
1005393,68896,15552,49578,92684,226710
1005394,55092,33046,89815,47890,225843
1005395,70946,14123,15016,86203,186288
1005396,63946,53079,62894,24872,204791
1005397,36948,93462,19680,68477,218567
1005398,96051,34511,84924,26606,242092
1005399,58119,97483,25725,7220,188547
1005400,56632,93651,85305,16593,252181
1005401,83137,95311,87414,33183,299045
1005402,16989,50939,57368,63615,188911
1005403,81349,18284,66836,56820,223289
1005404,31144,29104,9467,28214,97929
1005405,40300,27398,92673,83541,243912
1005406,22324,33990,32348,84059,172721
1005407,12723,40883,1504,45152,100262
1005408,45877,60586,98607,8558,213628
1005409,2263,26936,1290,20345,50834
1005410,61252,71199,2406,17830,152687
1005411,37275,86275,4184,16283,144017
1005412,72979,47469,32628,7473,160549
1005413,71117,91137,61308,74270,297832
1005414,15859,10559,30673,11615,68706
1005415,7641,30514,95383,80343,213881
1005416,74057,3706,98132,26787,202682
1005417,28292,28924,84987,96991,239194
1005418,8789,67269,48564,82286,206908
1005419,32461,18731,17039,16398,84629
1005420,18149,50619,73074,53277,195119
1005421,42683,59799,2560,36573,141615
1005422,77490,6398,82032,37732,203652
1005423,96268,45890,48114,72157,262429
1005424,49009,15155,58713,61611,184488
1005425,15434,84948,32320,77282,209984
1005426,48045,2798,8749,9980,69572
1005427,1402,61367,49355,58686,170810
1005428,5231,58634,73702,54387,191954
1005429,90198,65423,87218,15598,258437
1005430,25282,41671,87807,72815,227575
1005431,23341,32860,4876,19448,80525
1005432,99790,83496,308,78409,262003
1005433,1823,14249,61702,65715,143489
1005434,80247,96286,76309,56272,309114
1005435,92661,29985,8746,85359,216751
1005436,78846,39714,26482,24552,169594
1005437,98030,42941,55758,27732,224461
1005438,66219,24073,45263,53956,189511
1005439,57483,88278,40740,61027,247528
1005440,37727,71573,2198,88848,200346
1005441,32371,29862,43473,71958,177664
1005442,27485,97770,6101,78582,209938
1005443,29532,30753,31598,14573,106456
1005444,29200,31844,65724,6406,133174
1005445,73745,94590,17140,58285,243760
1005446,97086,97923,45685,66251,306945
1005447,52413,98680,1642,21829,174564
1005448,72003,13471,752,93510,179736
1005449,53677,59122,74489,62985,250273
1005450,70646,53876,59682,28171,212375
1005451,65119,10190,46608,24645,146562
1005452,41496,21286,6358,22167,91307
1005453,95468,10725,8772,34475,149440
1005454,1953,15775,79438,24951,122117
1005455,31323,92998,38645,37320,200286
1005456,87042,72953,72090,24984,257069
1005457,84396,38045,7709,84253,214403
1005458,1106,71335,67239,96642,236322
1005459,12402,63150,45784,13542,134878
1005460,50316,19118,82460,79584,231478
1005461,43059,11898,52738,2234,109929
1005462,11807,66178,44081,66389,188455
1005463,31868,44031,83985,11724,171608
1005464,58787,15820,70671,54119,199397
1005465,55601,48540,23682,88901,216724
1005466,86568,69188,41032,49123,245911
1005467,7365,83904,18103,18975,128347
1005468,2500,87834,80631,19404,190369
1005469,14959,64336,78544,3142,160981
1005470,75842,16818,18886,81889,193435
1005471,78107,9205,50138,39185,176635
1005472,14752,76148,3964,81815,176679
1005473,36477,3424,92551,22456,154908
1005474,29,64453,58815,17453,140750
1005475,529,43173,29421,39159,112282
1005476,99885,58425,45430,75984,279724
1005477,29143,921,76575,2895,109534
1005478,61496,44139,49758,60302,215695
1005479,90808,68349,39999,89149,288305
1005480,60081,2875,7213,45693,115862
1005481,44643,10057,23895,25032,103627
1005482,51732,46048,41088,87658,226526
1005483,17175,37166,18662,13499,86502
1005484,30563,72568,22260,80162,205553
1005485,94129,86695,90472,41222,312518
1005486,74754,36989,29221,79184,220148
1005487,37940,89881,85589,15295,228705
1005488,67090,30436,74751,28300,200577
1005489,49718,22114,57211,57244,186287
1005490,21667,39488,29758,55609,146522
1005491,61144,6860,84243,77116,229363
1005492,57939,13091,6752,34729,112511
1005493,85972,16454,48551,41705,192682
1005494,57724,95828,47989,50712,252253
1005495,42890,75160,35267,83935,237252
1005496,68450,21366,49477,87588,226881
1005497,49298,15643,46561,62114,173616
1005498,82896,39248,71473,17808,211425
1005499,79952,63188,46475,15795,205410
1005500,44010,10425,43481,82515,180431
1005501,41189,61744,66605,27634,197172
1005502,41829,39265,84101,13505,178700
1005503,87595,35823,38020,6698,168136
1005504,66700,62653,69908,36232,235493
1005505,13476,95830,40747,93312,243365
1005506,71990,66888,30540,80287,249705
1005507,40233,19095,58767,46225,164320
1005508,30694,5209,11694,61462,109059
1005509,66241,1911,75549,85410,229111
1005510,10653,51954,82066,8412,153085
1005511,70488,25468,10798,80062,186816
1005512,74080,1190,15023,99938,190231
1005513,52993,1920,10415,5573,70901
1005514,25549,92517,13131,73089,204286
1005515,81384,23491,57364,29966,192205
1005516,99178,95133,91723,91346,377380
1005517,41082,75406,4839,89637,210964
1005518,31991,1027,67896,78256,179170
1005519,70809,86114,78870,36485,272278
1005520,23326,7899,60254,67435,158914
1005521,65118,95773,30593,72315,263799
1005522,18518,40198,40128,18571,117415
1005523,75360,94464,94037,31801,295662
1005524,88152,76239,38239,35228,237858
1005525,7737,5106,98956,72683,184482
1005526,32144,70090,47178,69794,219206
1005527,88338,71185,65716,54522,279761
1005528,66587,33367,28748,76640,205342
1005529,68314,99938,36205,37313,241770
1005530,42822,64152,51519,36294,194787
1005531,67749,49293,93302,41261,251605
1005532,28417,49854,16522,89085,183878
1005533,42268,9378,9476,38517,99639
1005534,49882,44130,23211,27451,144674
1005535,12805,58968,86742,17027,175542
1005536,55555,26171,75398,21216,178340
1005537,6587,45628,62470,9839,124524
1005538,63219,45859,9672,71098,189848
1005539,4767,83882,62600,1813,153062
1005540,45990,16778,2900,21373,87041
1005541,1688,10532,85223,40590,138033
1005542,73216,82736,80178,35852,271982
1005543,56028,13863,67259,94252,231402
1005544,8682,10035,43626,34070,96413
1005545,36257,10731,17885,55247,120120
1005546,96388,60708,48519,83034,288649
1005547,35263,47409,19953,69943,172568
1005548,25415,96228,34902,31665,188210
1005549,39852,73652,22404,56282,192190
1005550,39846,892,55968,50078,146784
1005551,78409,64771,84088,90834,318102
1005552,95781,13523,45047,23924,178275
1005553,24771,90391,95132,75559,285853
1005554,3623,45084,60863,47862,157432
1005555,70038,81454,70641,47205,269338
1005556,73326,38221,91502,52311,255360
1005557,39550,90027,88011,91953,309541
1005558,20757,35654,36672,37652,130735
1005559,86710,28422,47001,93904,256037
1005560,6736,11905,44285,14209,77135
1005561,1796,8643,62512,60633,133584
1005562,97276,90503,46262,83440,317481
1005563,39956,81990,3810,23395,149151
1005564,17783,67433,75020,75254,235490
1005565,47324,38731,96694,29194,211943
1005566,43492,61919,53342,43572,202325
1005567,83374,94127,72844,46910,297255
1005568,89082,44697,48351,8887,191017
1005569,42540,16528,95844,32683,187595
1005570,34763,2113,5229,64567,106672
1005571,34169,46203,48762,43993,173127
1005572,52632,60365,90051,4113,207161
1005573,28991,8225,89706,85100,212022
1005574,96080,88070,4279,62124,250553
1005575,69122,6511,92505,84194,252332
1005576,37673,39892,18455,48566,144586
1005577,27187,65357,63162,70375,226081
1005578,38167,65544,67289,98509,269509
1005579,47578,30822,68986,49691,197077
1005580,83270,85163,17364,49980,235777
1005581,84902,54687,40899,40353,220841
1005582,84942,89900,50711,50964,276517
1005583,60272,43553,46440,75701,225966
1005584,93344,38912,26551,29251,188058
1005585,94611,26371,43975,91590,256547
1005586,69572,4618,42880,45345,162415
1005587,44687,9075,55967,4533,114262
1005588,89295,75227,41300,68369,274191
1005589,30427,26593,71962,6252,135234
1005590,75855,27067,83765,96444,283131
1005591,1839,28248,31669,91539,153295
1005592,23074,32664,30471,59797,146006
1005593,87660,6858,56159,85789,236466
1005594,69773,97765,29707,73939,271184
1005595,4279,33237,36654,80318,154488
1005596,89741,86409,19102,61843,257095
1005597,97269,48608,29306,97026,272209
1005598,58191,21429,37605,59628,176853
1005599,15550,34206,87818,58803,196377
1005600,66614,15625,60637,60226,203102
1005601,22058,91684,34055,20110,167907
1005602,69007,64424,69636,40473,243540
1005603,90227,50354,62274,763,203618
1005604,95175,86742,58795,49623,290335
1005605,89102,24704,84651,77048,275505
1005606,48002,60935,73201,2020,184158
1005607,51338,90701,31619,34023,207681
1005608,63554,1777,69437,26292,161060
1005609,14185,37000,1005,42679,94869
1005610,14864,71704,10859,64732,162159
1005611,39526,10808,89649,4131,144114
1005612,93322,65015,67409,13208,238954
1005613,15001,32628,75454,23038,146121
1005614,30828,51770,82039,61251,225888
1005615,2499,55603,90512,65023,213637
1005616,40823,71814,58568,4088,175293
1005617,53815,94579,13183,44769,206346
1005618,20885,83369,25000,69334,198588
1005619,23571,29126,71800,23948,148445
1005620,20380,25985,13144,89357,148866
1005621,85830,96848,28371,57251,268300
1005622,45405,13982,64835,6323,130545
1005623,15122,92181,25442,95402,228147
1005624,67289,36747,72128,92039,268203
1005625,82703,31,69366,91348,243448
1005626,84122,69574,64387,73658,291741
1005627,22703,96268,92739,73620,285330
1005628,26743,10221,9770,10040,56774
1005629,4136,68777,12493,62989,148395
1005630,93462,31133,7477,58761,190833
1005631,21237,93760,19139,92736,226872
1005632,86785,96297,8091,87953,279126
1005633,15716,90489,75839,93710,275754
1005634,69345,3782,37632,59225,169984
1005635,38469,1554,57048,63487,160558
1005636,73616,24481,9549,16687,124333
1005637,27474,99658,31038,28983,187153
1005638,1944,65957,13885,73456,155242
1005639,80245,2350,11566,46024,140185
1005640,32922,26887,34705,91054,185568
1005641,17637,16146,65189,94015,192987
1005642,4259,80634,43845,35799,164537
1005643,30396,8426,74942,35746,149510
1005644,33265,76358,61515,25287,196425
1005645,48029,36650,79023,68801,232503
1005646,40184,69182,48240,82860,240466
1005647,83471,17934,96993,24092,222490
1005648,13505,25324,50933,45160,134922
1005649,93408,59177,30452,84088,267125
1005650,11698,46673,68461,35425,162257
1005651,25863,40656,55042,87695,209256
1005652,97784,10525,40637,53511,202457
1005653,72306,58430,14744,64413,209893
1005654,69441,49290,67227,47828,233786
1005655,52676,64987,21768,7082,146513
1005656,53886,40027,61005,74997,229915
1005657,98856,7888,19869,52785,179398
1005658,46833,68011,33575,23911,172330
1005659,28401,16013,62193,80069,186676
1005660,2298,25819,43581,84210,155908
1005661,72628,65783,18067,33062,189540
1005662,68788,81746,17220,9025,176779
1005663,45320,47462,5552,45515,143849
1005664,48236,84891,37572,18263,188962
1005665,2496,19780,54660,31872,108808
1005666,63762,42865,48516,24618,179761
1005667,22820,2345,45513,27895,98573
1005668,10837,7906,14007,40770,73520
1005669,44479,91080,20239,39859,195657
1005670,22361,23801,14365,3516,64043
1005671,32925,26441,1693,21802,82861
1005672,50554,99801,51751,56800,258906
1005673,90948,11432,96688,71018,270086
1005674,62131,25076,70018,26689,183914
1005675,57375,8743,13579,76049,155746
1005676,28798,38365,15568,29965,112696
1005677,42610,36118,9438,75556,163722
1005678,66347,32997,27190,39518,166052
1005679,25042,87580,68593,36718,217933
1005680,93224,14446,14415,70782,192867
1005681,74132,3623,24579,12569,114903
1005682,63089,52128,80843,14649,210709
1005683,30229,48132,40836,21076,140273
1005684,13693,80772,36635,96496,227596
1005685,79494,94684,14470,77556,266204
1005686,84981,64125,90710,78137,317953
1005687,12035,18282,77745,63838,171900
1005688,2381,51685,81335,76802,212203
1005689,25005,67302,7483,29101,128891
1005690,59058,18932,20331,13426,111747
1005691,87773,17882,20194,60152,186001
1005692,47903,75107,46919,30240,200169
1005693,75849,85788,68658,9172,239467
1005694,78233,61508,77124,42388,259253
1005695,20918,9921,54140,40953,125932
1005696,65894,2705,62216,74330,205145
1005697,99594,87477,22909,83642,293622
1005698,37308,94156,12909,79279,223652
1005699,23709,38582,76414,35858,174563
1005700,88940,79839,65574,6837,241190
1005701,98703,36992,52781,45166,233642
1005702,68454,35883,3977,69577,177891
1005703,37294,84025,64909,41316,227544
1005704,92224,50167,44265,99428,286084
1005705,71349,63490,6927,24883,166649
1005706,24570,74283,16657,15751,131261
1005707,20216,71137,39727,19434,150514
1005708,61470,22677,7541,42339,134027
1005709,32634,23495,37511,90274,183914
1005710,79688,80236,49905,1348,211177
1005711,28670,43731,16521,95520,184442
1005712,73060,23690,64886,5529,167165
1005713,97603,46385,33965,70840,248793
1005714,77200,82066,41196,13004,213466
1005715,54725,24420,73109,85378,237632
1005716,35531,88084,8257,95296,227168
1005717,54034,76500,67536,12389,210459
1005718,83813,77210,96758,46513,304294
1005719,79006,42936,66194,23035,211171
1005720,24613,79874,46203,16002,166692
1005721,47552,73043,83375,63512,267482
1005722,47958,58113,4603,62614,173288
1005723,91928,18370,12790,26872,149960
1005724,74146,61842,59640,4014,199642
1005725,5822,73505,59952,87528,226807
1005726,82008,53152,13213,87221,235594
1005727,89514,87357,40831,64883,282585
1005728,81237,74227,74611,78644,308719
1005729,94312,780,48221,31224,174537
1005730,43537,79525,93667,86686,303415
1005731,55162,46776,37230,45935,185103
1005732,13933,54031,38198,90712,196874
1005733,79663,30714,58172,43122,211671
1005734,48808,69738,71932,16646,207124
1005735,75788,68946,53709,77807,276250
1005736,40623,1729,60907,15301,118560
1005737,30415,69045,97290,69104,265854
1005738,98259,60119,24604,48743,231725
1005739,1030,45270,41469,34104,121873
1005740,12156,50277,32521,15362,110316
1005741,40387,17674,20086,61714,139861
1005742,49166,57561,17500,61923,186150
1005743,99445,66604,49584,64993,280626
1005744,42708,30707,99821,79816,253052
1005745,74887,70231,29922,3844,178884
1005746,87940,58944,60981,55943,263808
1005747,518,38961,93186,73686,206351
1005748,45336,24284,38790,95574,203984
1005749,13421,65772,53797,74750,207740
1005750,15192,27032,55522,67143,164889
1005751,80640,66615,12583,28171,188009
1005752,70609,81955,90048,72467,315079
1005753,43248,66646,44769,53031,207694
1005754,32997,79674,7341,95537,215549
1005755,9825,70622,64588,69628,214663
1005756,53247,33240,79006,76309,241802
1005757,89690,31344,11097,26063,158194
1005758,48368,93520,85045,23403,250336
1005759,51361,23718,54288,84889,214256
1005760,58044,42753,93094,93043,286934
1005761,31021,45524,92673,82009,251227
1005762,39476,71996,51231,53487,216190
1005763,96772,35643,49177,27052,208644
1005764,6896,13261,20519,83225,123901
1005765,9023,87649,45302,2509,144483
1005766,80919,41493,31111,77168,230691
1005767,34265,38520,93041,63634,229460
1005768,5746,98828,27322,65489,197385
1005769,93625,19575,43266,52689,209155
1005770,72681,33941,28506,22184,157312
1005771,42098,52520,23482,83425,201525
1005772,56906,75926,85257,6123,224212
1005773,42815,87818,45727,29121,205481
1005774,12156,72302,91590,36776,212824
1005775,74826,90501,71064,41482,277873
1005776,62545,91736,78675,62863,295819
1005777,16838,95896,62885,93628,269247
1005778,77853,50184,2635,34304,164976
1005779,9589,80899,33119,30102,153709
1005780,52885,78434,66838,25579,223736
1005781,63919,46653,91253,75190,277015
1005782,85161,97100,37092,71240,290593
1005783,93412,21396,1059,11656,127523
1005784,97661,96048,47107,89230,330046
1005785,2796,75058,77322,30978,186154
1005786,34318,62613,45779,98369,241079
1005787,40838,6929,53589,9699,111055
1005788,85106,46151,99831,76304,307392
1005789,695,54808,80542,5587,141632
1005790,66785,909,76549,52919,197162
1005791,75033,68140,96191,30849,270213
1005792,5841,59011,70078,48991,183921
1005793,57049,71404,23973,86357,238783
1005794,52405,73251,78557,15956,220169
1005795,52920,51096,55612,15013,174641
1005796,38721,34426,9833,86082,169062
1005797,75005,65037,5573,82917,228532
1005798,47981,17685,16117,78868,160651
1005799,11220,44335,93053,16940,165548
1005800,50824,34911,76423,77548,239706
1005801,36594,42511,97313,68374,244792
1005802,21082,72042,30768,83889,207781
1005803,161,76036,52449,13080,141726
1005804,65333,75941,84757,22285,248316
1005805,86638,77025,50637,11714,226014
1005806,22449,20047,91727,45275,179498
1005807,96613,61151,59674,55765,273203
1005808,95555,39153,40469,2309,177486
1005809,87693,52749,33910,81280,255632
1005810,64062,32526,96907,16771,210266
1005811,92004,18588,40440,42565,193597
1005812,404,25470,70363,22947,119184
1005813,2236,19772,98839,41033,161880
1005814,22196,92440,23595,95209,233440
1005815,83415,14554,92178,45741,235888
1005816,5797,19980,30290,68040,124107
1005817,57688,36738,34425,88505,217356
1005818,99980,27848,66337,88146,282311
1005819,16883,88894,20943,95234,221954
1005820,68881,74240,5492,22805,171418
1005821,87853,15474,61619,38909,203855
1005822,41187,184,50416,11725,103512
1005823,30696,21598,93666,83576,229536
1005824,3440,60675,85123,12443,161681
1005825,10971,6048,11351,61506,89876
1005826,41030,55353,9415,94476,200274
1005827,97439,87801,19065,95,204400
1005828,8660,47786,61284,12174,129904
1005829,43637,22221,7822,30625,104305
1005830,59973,82060,81088,7138,230259
1005831,5058,92063,80268,9252,186641
1005832,69722,59308,17473,57401,203904
1005833,3547,67460,27980,2406,101393
1005834,72017,85650,42499,93744,293910
1005835,2962,6256,92610,52307,154135
1005836,76229,73760,5869,87887,243745
1005837,31871,39275,43162,97715,212023
1005838,55434,97369,35407,8163,196373
1005839,60014,85297,16267,82578,244156
1005840,54522,79003,99519,79378,312422
1005841,88636,56610,14507,32689,192442
1005842,20471,87781,50432,84246,242930
1005843,82271,3954,55350,14707,156282
1005844,64589,50388,22245,53521,190743
1005845,34654,16773,19573,29519,100519
1005846,56532,1982,62734,30747,151995
1005847,34523,86252,54547,30636,205958
1005848,91036,9432,30395,52693,183556
1005849,78499,14553,15350,55435,163837
1005850,69921,3954,87639,387,161901
1005851,82448,56250,88221,48341,275260
1005852,51436,91094,2418,1071,146019
1005853,60026,66925,52897,17045,196893
1005854,69650,24346,66114,24202,184312
1005855,37368,73696,42380,63596,217040
1005856,8310,10251,2090,49680,70331
1005857,98224,30969,15199,80734,225126
1005858,33810,61933,12496,51082,159321
1005859,65282,48454,4898,88186,206820
1005860,81478,80456,43693,69139,274766
1005861,99637,34815,50517,20899,205868
1005862,94357,39950,9415,95857,239579
1005863,57095,78171,3849,82379,221494
1005864,69550,59233,72339,23471,224593
1005865,74859,92135,41079,9195,217268
1005866,94350,3755,60195,8662,166962
1005867,67169,78245,95060,28521,268995
1005868,80024,13949,18313,48069,160355
1005869,71515,27001,52886,92612,244014
1005870,81662,4401,79805,77329,243197
1005871,2608,62955,64012,74318,203893
1005872,54993,88801,85940,4957,234691
1005873,67479,18734,77177,68709,232099
1005874,75926,11016,74632,3225,164799
1005875,45012,93370,64502,59462,262346
1005876,24232,95458,11162,24888,155740
1005877,84230,50063,76556,45348,256197
1005878,95719,68249,21472,44313,229753
1005879,38993,88704,8312,69762,205771
1005880,11256,64696,42012,77489,195453
1005881,82952,67748,65295,36946,252941
1005882,84941,86716,30927,14310,216894
1005883,43994,37369,44789,5949,132101
1005884,50916,48596,28233,77628,205373
1005885,79635,93312,68878,49470,291295
1005886,16922,55917,87252,88914,249005
1005887,24533,60549,72506,30436,188024
1005888,66210,59956,12083,56450,194699
1005889,62129,33138,19595,45612,160474
1005890,23091,48003,37944,65973,175011
1005891,13107,68993,26845,51081,160026
1005892,87738,30304,57241,95886,271169
1005893,31239,48249,96632,761,176881
1005894,47770,14870,74140,22458,159238
1005895,62748,10410,63888,36903,173949
1005896,4820,50417,16247,72019,143503
1005897,69293,89913,73700,80981,313887
1005898,11794,8098,87156,67654,174702
1005899,18449,782,26062,75427,120720
1005900,21520,5117,71718,31031,129386
1005901,4766,51152,19733,60738,136389
1005902,16428,4923,88781,96815,206947
1005903,44777,57911,71670,44182,218540
1005904,10385,15908,79042,32986,138321
1005905,18414,18007,74577,17911,128909
1005906,14202,38131,38052,21976,112361
1005907,32244,13007,39888,89426,174565
1005908,37205,15737,83477,59595,196014
1005909,21057,55521,20850,98727,196155
1005910,9592,12954,51796,18851,93193
1005911,88679,79841,45338,92836,306694
1005912,76941,74752,70861,6903,229457
1005913,51780,33469,95097,89556,269902
1005914,60683,66356,39441,642,167122
1005915,78435,29063,65755,9820,183073
1005916,2924,24460,51216,29426,108026
1005917,59077,30029,33732,21479,144317
1005918,24853,65428,91650,98720,280651
1005919,83383,40122,43158,579,167242
1005920,81017,86993,2482,72486,242978
1005921,55261,89155,33225,78984,256625
1005922,70696,80606,72250,61546,285098
1005923,56409,5373,50145,15171,127098
1005924,25051,75048,96288,26371,222758
1005925,54017,9615,67470,91800,222902
1005926,77782,74039,74199,8438,234458
1005927,44656,80410,68808,87348,281222
1005928,95694,72785,52848,65399,286726
1005929,32015,85767,39021,5089,161892
1005930,12652,8385,65504,61972,148513
1005931,49745,92350,72883,99717,314695
1005932,59361,35707,78915,59077,233060
1005933,78530,73306,85534,97852,335222
1005934,94211,5177,18166,36875,154429
1005935,87074,29835,133,13621,130663
1005936,69759,78764,69714,46165,264402
1005937,82800,11143,15961,62667,172571
1005938,41392,18425,94440,91519,245776
1005939,73148,70081,78653,16568,238450
1005940,66022,20447,22281,65863,174613
1005941,48359,48651,28782,29082,154874
1005942,59268,31202,91783,75534,257787
1005943,32648,95813,92401,4563,225425
1005944,53646,1558,34525,65247,154976
1005945,88464,1969,2705,3395,96533
1005946,77263,16078,97954,67689,258984
1005947,33706,29913,82424,24181,170224
1005948,79434,39647,95469,6093,220643
1005949,90614,39010,27404,76632,233660
1005950,24857,44641,48294,46923,164715
1005951,9100,12508,20857,14764,57229
1005952,93836,75280,73667,56852,299635
1005953,23099,53974,90466,53512,221051
1005954,46297,46494,81785,27660,202236
1005955,17573,98428,76403,45773,238177
1005956,64386,74203,30694,88668,257951
1005957,7981,16985,96969,92351,214286
1005958,73956,18895,74943,9088,176882
1005959,71692,63515,39959,97224,272390
1005960,9621,57992,15860,97827,181300
1005961,4198,5698,20671,13817,44384
1005962,60664,81860,31944,58475,232943
1005963,43032,1026,29628,47357,121043
1005964,31742,1419,7195,63014,103370
1005965,66836,80965,71305,56764,275870
1005966,98470,88637,23918,82294,293319
1005967,41781,25880,55469,84150,207280
1005968,96581,6129,76755,35825,215290
1005969,563,20229,22682,9594,53068
1005970,87658,43562,84824,33145,249189
1005971,32773,3291,11898,16121,64083
1005972,86399,79755,20274,13824,200252
1005973,46748,94266,12858,72338,226210
1005974,59815,90835,3371,32590,186611
1005975,39891,47862,52607,64850,205210
1005976,70206,87108,33792,23742,214848
1005977,55196,55026,43207,63668,217097
1005978,47483,57167,92581,63041,260272
1005979,3665,40306,96697,92263,232931
1005980,36809,25999,67606,38814,169228
1005981,83021,4361,37054,53076,177512
1005982,44180,94556,80669,41373,260778
1005983,13034,40055,99187,76451,228727
1005984,45936,47280,38892,41557,173665
1005985,99242,47881,51264,45320,243707
1005986,98873,3996,74750,2421,180040
1005987,19265,31281,49853,55500,155899
1005988,11390,17235,7531,23502,59658
1005989,58392,22224,56074,98306,234996
1005990,30788,59289,67681,70702,228460
1005991,59212,71149,90731,41499,262591
1005992,92402,29049,4956,32446,158853
1005993,63292,19701,50246,33774,167013
1005994,44436,33977,74345,72794,225552
1005995,94729,95763,15040,63771,269303
1005996,74102,39930,80204,19321,213557
1005997,28060,93085,17782,79491,218418
1005998,49987,34019,89856,77480,251342
1005999,61224,57890,81922,25027,226063
1006000,31335,73598,12698,62610,180241
1006001,57744,19522,66086,3068,146420
1006002,55730,91865,22154,47175,216924
1006003,29195,23791,57357,69444,179787
1006004,61635,35024,1587,34645,132891
1006005,56798,25167,59024,6931,147920
1006006,75380,87436,40085,33180,236081
1006007,95825,69622,55589,15555,236591
1006008,85243,86257,11799,70856,254155
1006009,28486,79344,26356,18234,152420
1006010,52610,12129,62616,48644,175999
1006011,37129,91520,18252,84065,230966
1006012,845,81779,28599,62128,173351
1006013,52586,54609,54744,88604,250543
1006014,2549,88938,45034,32686,169207
1006015,55193,9173,68634,59674,192674
1006016,14468,78526,54207,85181,232382
1006017,6358,66606,56683,28317,157964
1006018,5827,31206,58838,3583,99454
1006019,34107,66087,76076,15999,192269
1006020,62773,3241,15345,47963,129322
1006021,51860,57841,50747,30907,191355
1006022,20956,31808,59600,11817,124181
1006023,17636,27550,52126,3061,100373
1006024,75798,3624,96487,97970,273879
1006025,70207,93489,6943,67904,238543
1006026,21123,39181,25867,24265,110436
1006027,49330,99960,18951,4600,172841
1006028,28819,70035,84391,80746,263991
1006029,95364,86968,93502,38494,314328
1006030,42044,94215,99342,4049,239650
1006031,28870,46146,59861,53100,187977
1006032,35758,81084,34865,93100,244807
1006033,55535,47926,67245,37785,208491
1006034,78116,17886,9574,47290,152866
1006035,69526,75340,33762,73986,252614
1006036,47973,60273,60791,34085,203122
1006037,57441,28560,82725,40232,208958
1006038,13287,57416,71890,56661,199254
1006039,59071,98541,20142,88470,266224
1006040,33553,73650,69631,67854,244688
1006041,14251,58047,72103,10826,155227
1006042,88539,97916,71227,98012,355694
1006043,749,80419,30755,79482,191405
1006044,35055,45152,58328,82547,221082
1006045,41590,25573,45317,27710,140190
1006046,14379,94343,72148,57795,238665
1006047,60484,43170,68775,7649,180078
1006048,64651,40856,81370,24258,211135
1006049,54059,15069,93995,68768,231891
1006050,95202,75394,26477,9321,206394
1006051,73389,4997,9918,71100,159404
1006052,92130,2432,94165,35912,224639
1006053,29842,33791,63812,25030,152475
1006054,70967,41659,90063,70531,273220
1006055,98931,59114,32896,41336,232277
1006056,92404,7306,29028,90623,219361
1006057,4799,68231,95980,46532,215542
1006058,54779,58012,81388,73482,267661
1006059,55644,79384,8430,92769,236227
1006060,6328,13603,49095,74807,143833
1006061,73516,73620,44012,88386,279534
1006062,66368,38846,78386,2945,186545
1006063,29102,33939,92790,98702,254533
1006064,42769,92429,92315,67499,295012
1006065,31323,70811,13750,9714,125598
1006066,77311,73524,90412,58927,300174
1006067,72007,88138,21190,13119,194454
1006068,93994,21822,36553,31561,183930
1006069,74559,94296,22361,73268,264484
1006070,94008,26289,75142,98230,293669
1006071,23352,15680,15874,72432,127338
1006072,11075,44530,22799,838,79242
1006073,47505,76584,73207,17953,215249
1006074,15527,57241,23128,82077,177973
1006075,29021,24684,10006,17573,81284
1006076,96994,40611,17869,71955,227429
1006077,95726,12367,41427,22042,171562
1006078,30427,66321,98875,86062,281685
1006079,52212,44693,72229,56763,225897
1006080,76805,13879,40801,12787,144272
1006081,51105,92865,18314,60528,222812
1006082,83881,78638,83241,78705,324465
1006083,53616,22292,50168,72676,198752
1006084,71405,57489,58450,52137,239481
1006085,29059,46318,9429,17794,102600
1006086,19915,57720,35008,51755,164398
1006087,73150,44393,62731,63320,243594
1006088,24814,18553,44554,46366,134287
1006089,90370,27489,92991,6948,217798
1006090,52905,589,10649,85638,149781
1006091,13357,15621,54021,19457,102456
1006092,80856,50224,35686,12591,179357
1006093,49578,68359,68546,32950,219433
1006094,2234,971,20902,39755,63862
1006095,76943,89614,32471,12727,211755
1006096,83332,27458,75231,22685,208706
1006097,22529,26895,35257,45921,130602
1006098,13057,41026,17520,58764,130367
1006099,59854,47626,76902,9165,193547
1006100,43142,52191,9259,90506,195098
1006101,48929,86715,6427,91565,233636
1006102,38815,9836,32317,2574,83542
1006103,13219,92610,27282,414,133525
1006104,24754,96894,29712,84658,236018
1006105,13520,76876,11837,63540,165773
1006106,35884,97243,41677,64445,239249
1006107,33235,99127,42130,83891,258383
1006108,50708,54035,96775,23771,225289
1006109,47157,25619,92575,84925,250276
1006110,27707,60310,56006,30554,174577
1006111,13856,70317,1170,92540,177883
1006112,93865,6185,85210,35814,221074
1006113,14395,68587,58905,57519,199406
1006114,68489,61027,77658,31457,238631
1006115,52713,68804,85245,38127,244889
1006116,17886,99282,70602,16935,204705
1006117,25128,23183,86323,66629,201263
1006118,47682,33353,29541,54137,164713
1006119,93880,25397,82128,29053,230458
1006120,68986,73300,8173,37539,187998
1006121,77282,25801,8096,77773,188952
1006122,53379,63986,53910,50855,222130
1006123,71763,64892,39657,72612,248924
1006124,49360,16468,33899,8206,107933
1006125,41608,11999,61931,98752,214290
1006126,84367,94420,11700,458,190945
1006127,66704,17029,12692,59604,156029
1006128,32710,45663,67093,90401,235867
1006129,82817,84326,79148,26788,273079
1006130,75944,17037,29947,66452,189380
1006131,91908,78897,89207,70520,330532
1006132,64782,7744,32313,67581,172420
1006133,70373,27394,21564,80903,200234
1006134,40219,46888,60457,1716,149280
1006135,87823,81915,38140,18010,225888
1006136,50184,51586,11527,24128,137425
1006137,63381,10637,84305,39457,197780
1006138,84623,46887,35515,25512,192537
1006139,37932,4956,98229,40970,182087
1006140,15870,21559,60517,88196,186142
1006141,28163,77992,28928,83424,218507
1006142,47599,53758,64987,63277,229621
1006143,66315,13095,53394,77827,210631
1006144,43866,23709,5155,4652,77382
1006145,70955,56496,476,42771,170698
1006146,45154,89952,73641,89052,297799
1006147,70095,70505,32166,58882,231648
1006148,69097,32285,1276,6294,108952
1006149,69241,70434,16170,83642,239487
1006150,91008,9211,17898,13489,131606
1006151,4058,56131,18919,8966,88074
1006152,98048,52133,18561,95521,264263
1006153,6631,4092,61170,30251,102144
1006154,13714,1325,92423,74093,181555
1006155,2380,9622,86133,29102,127237
1006156,20561,60214,31050,8154,119979
1006157,19220,26120,50994,30720,127054
1006158,34812,500,21884,78223,135419
1006159,46180,88320,35573,70100,240173
1006160,55202,49139,6588,81732,192661
1006161,19278,38129,47262,21217,125886
1006162,61346,59622,46324,75484,242776
1006163,43338,73604,15645,10158,142745
1006164,76931,90183,33332,56998,257444
1006165,31223,13454,88098,34111,166886
1006166,52012,63446,30244,26621,172323
1006167,66632,55033,57599,26496,205760
1006168,67697,34066,44045,17109,162917
1006169,48501,20621,69080,50693,188895
1006170,14176,50342,39335,14490,118343
1006171,52496,52496,81114,81653,267759
1006172,55852,70097,10763,79772,216484
1006173,64508,41596,53626,49091,208821
1006174,64299,16189,44603,76678,201769
1006175,32924,24989,74389,75037,207339
1006176,76795,11937,34390,73514,196636
1006177,94891,88245,8248,28275,219659
1006178,85264,61308,95272,95269,337113
1006179,65558,53899,73695,81762,274914
1006180,88291,28233,99018,8355,223897
1006181,49633,97405,15870,86586,249494
1006182,3718,36051,12351,99321,151441
1006183,85427,52309,81520,43218,262474
1006184,74003,27653,6642,85388,193686
1006185,62611,64078,28871,8408,163968
1006186,43472,52924,74909,13482,184787
1006187,68287,63927,7142,76921,216277
1006188,48309,17467,15719,99853,181348
1006189,82221,89738,31876,21280,225115
1006190,36814,16151,97166,48378,198509
1006191,63770,59533,89485,81630,294418
1006192,56530,58106,37433,91480,243549
1006193,30032,38031,6560,4477,79100
1006194,30438,69070,20446,71037,190991
1006195,29922,89709,46329,70934,236894
1006196,51557,62238,72825,25895,212515
1006197,21328,53587,10921,22706,108542
1006198,615,5181,37186,26936,69918
1006199,12985,65466,29142,17836,125429
1006200,9496,53367,45997,29147,138007
1006201,58405,34429,60479,63627,216940
1006202,11442,52221,78789,16760,159212
1006203,45934,92518,1970,38272,178694
1006204,41615,91701,34559,68801,236676
1006205,59415,2155,95215,49982,206767
1006206,63538,64451,49038,67393,244420
1006207,78274,20774,26962,50349,176359
1006208,12614,95638,9267,63768,181287
1006209,99782,21535,84996,70021,276334
1006210,36329,85718,64661,63352,250060
1006211,23011,23147,92033,11484,149675
1006212,45876,95024,84479,64286,289665
1006213,14308,61559,18086,98709,192662
1006214,52160,42665,17370,22872,135067
1006215,36808,13320,27296,43439,120863
1006216,89159,69795,1164,77802,237920
1006217,4726,43264,2437,17515,67942
1006218,26452,5691,93766,659,126568
1006219,28068,84042,17925,28445,158480
1006220,73595,87035,63046,10170,233846
1006221,44517,28316,34184,69823,176840
1006222,6199,5716,5886,8040,25841
1006223,41702,86449,59401,82236,269788
1006224,25170,96158,59799,44359,225486
1006225,25575,12485,2283,85449,125792
1006226,63643,93987,97170,25319,280119
1006227,27269,57424,25522,14566,124781
1006228,95198,5738,31027,84576,216539
1006229,45219,42822,94326,6103,188470
1006230,4153,56888,68259,58064,187364
1006231,30190,5694,29847,48401,114132
1006232,58913,37485,25526,14694,136618
1006233,6004,9908,63340,18828,98080
1006234,27451,57389,77386,38705,200931
1006235,97843,86177,33691,81667,299378
1006236,87007,7115,36585,70913,201620
1006237,61708,10249,31832,77798,181587
1006238,56738,33824,27206,86638,204406
1006239,85556,99979,75953,33786,295274
1006240,3332,33475,69797,38053,144657
1006241,12025,64196,58823,42005,177049
1006242,29101,37054,51151,19330,136636
1006243,96,47653,53987,53746,155482
1006244,66678,73891,93861,47317,281747
1006245,81734,54336,58797,96901,291768
1006246,70983,58651,85032,28111,242777
1006247,62194,55362,89702,4397,211655
1006248,94970,1200,87657,21251,205078
1006249,74990,21977,47058,51560,195585
1006250,82894,19069,50703,75150,227816
1006251,19365,98011,64804,6732,188912
1006252,38684,74723,1475,29649,144531
1006253,34034,42039,2970,79848,158891
1006254,1019,32757,21970,40873,96619
1006255,71041,14917,12862,19821,118641
1006256,15569,44774,33236,41290,134869
1006257,63257,81637,24987,64201,234082
1006258,9231,12232,72879,85810,180152
1006259,1511,22288,66608,1121,91528
1006260,29686,17818,88144,77618,213266
1006261,33394,94345,60053,64342,252134
1006262,54536,94113,78740,34753,262142
1006263,28982,77851,8030,22742,137605
1006264,26969,82632,47805,8482,165888
1006265,80959,37526,5512,47933,171930
1006266,47282,90121,20373,92835,250611
1006267,71862,67385,30691,42343,212281
1006268,10480,17888,4136,32615,65119
1006269,75030,50010,83288,25609,233937
1006270,21906,56463,23110,81936,183415
1006271,21855,97047,63217,95902,278021
1006272,84622,80069,95821,40360,300872
1006273,63569,18089,1326,7602,90586
1006274,34571,97537,99434,91611,323153
1006275,24520,43198,37263,98616,203597
1006276,47531,36396,21683,99228,204838
1006277,39017,50115,4939,9662,103733
1006278,74380,70335,72943,80276,297934
1006279,40683,76589,41830,50599,209701
1006280,7384,37513,60941,92564,198402
1006281,59853,39911,45463,35315,180542
1006282,36252,53906,78643,14167,182968
1006283,61442,82375,18689,61449,223955
1006284,47840,52411,98336,35054,233641
1006285,10901,40383,16606,62922,130812
1006286,11026,32224,82192,46799,172241
1006287,51246,50910,95218,47038,244412
1006288,70360,12314,63310,81805,227789
1006289,74728,34680,18670,59748,187826
1006290,61391,28795,70308,363,160857
1006291,11405,2871,32969,5913,53158
1006292,83446,76575,1085,8736,169842
1006293,40439,20243,37935,45666,144283
1006294,92691,5667,943,42772,142073
1006295,96532,2828,71301,1860,172521
1006296,78800,29711,61549,21172,191232
1006297,82699,23728,43919,8131,158477
1006298,55083,36764,58624,20131,170602
1006299,20117,43877,11306,39348,114648
1006300,10289,85583,7842,50063,153777
1006301,77031,87260,19127,45610,229028
1006302,82972,48915,99824,6553,238264
1006303,92519,96414,70494,49433,308860
1006304,97264,31696,48498,17436,194894
1006305,50174,52958,16479,21349,140960
1006306,84717,26018,5004,41873,157612
1006307,90552,32768,93165,19851,236336
1006308,98105,44702,78965,98571,320343
1006309,93300,43695,59542,57155,253692
1006310,97569,98529,45341,78036,319475
1006311,61127,19681,39019,51701,171528
1006312,83274,59092,61231,84455,288052
1006313,89208,43389,58292,81943,272832
1006314,9439,97209,49008,61215,216871
1006315,32721,91173,40003,49996,213893
1006316,56095,22123,8847,94462,181527
1006317,99300,59175,68374,45427,272276
1006318,45592,20505,18276,60714,145087
1006319,40630,14175,48711,34212,137728
1006320,76822,2412,47078,81248,207560
1006321,30885,44846,30610,93755,200096
1006322,3464,96472,96647,31743,228326
1006323,90983,26508,37026,26963,181480
1006324,29091,30683,55937,24904,140615
1006325,47989,55625,43338,63732,210684
1006326,48268,88962,27274,49275,213779
1006327,27334,54978,2498,68583,153393
1006328,86920,19081,8584,63660,178245
1006329,41819,33255,76390,21100,172564
1006330,69944,57392,63838,52922,244096
1006331,72984,36626,26038,12860,148508
1006332,38221,15823,54359,58169,166572
1006333,25101,25866,63895,31535,146397
1006334,61628,33997,15712,23677,135014
1006335,37986,94797,91290,53689,277762
1006336,96,53929,76524,32427,162976
1006337,38151,73064,15527,27677,154419
1006338,70029,45229,46662,41205,203125
1006339,72488,40128,76323,53750,242689
1006340,36051,78163,72732,95869,282815
1006341,81707,77736,67615,34485,261543
1006342,49065,58210,83946,94845,286066
1006343,54774,61651,67479,20893,204797
1006344,67833,69585,43316,13133,193867
1006345,45215,82532,31385,91513,250645
1006346,53594,64412,44703,1960,164669
1006347,36135,72466,88387,8449,205437
1006348,82597,44350,26075,84464,237486
1006349,65798,67531,7358,83914,224601
1006350,10850,32379,83014,53862,180105
1006351,37406,357,93969,81319,213051
1006352,97082,80027,11789,25001,213899
1006353,5295,34891,69258,95613,205057
1006354,56454,30764,84971,6216,178405
1006355,81177,1852,91412,89908,264349
1006356,88211,97091,16766,24474,226542
1006357,95027,73578,59129,1744,229478
1006358,3620,56329,68416,76572,204937
1006359,39786,49202,40155,28038,157181
1006360,83115,47292,74836,18656,223899
1006361,24086,75282,13809,84955,198132
1006362,7334,61161,61451,42085,172031
1006363,95709,57902,98847,67748,320206
1006364,59415,19312,38815,56947,174489
1006365,52654,13355,33126,45251,144386
1006366,94984,5698,85113,91934,277729
1006367,73377,82277,60781,5323,221758
1006368,16448,62510,10655,8271,97884
1006369,78332,50034,43976,55164,227506
1006370,82461,72073,69091,11780,235405
1006371,50813,87519,4273,23544,166149
1006372,34204,50148,6083,98750,189185
1006373,93036,57666,7649,38961,197312
1006374,24287,3785,81411,80211,189694
1006375,54648,96919,64374,73200,289141
1006376,89756,37578,30071,69585,226990
1006377,57275,36513,56267,69156,219211
1006378,89796,44951,53216,98098,286061
1006379,19109,58578,70533,53350,201570
1006380,38514,78509,57921,31983,206927
1006381,65682,9978,93264,76802,245726
1006382,64529,86945,60735,63662,275871
1006383,37719,42031,8952,51597,140299
1006384,47831,302,8265,26015,82413
1006385,4382,8232,63846,47816,124276
1006386,90528,24999,61998,84589,262114
1006387,99369,25038,2663,97328,224398
1006388,53008,32646,47530,59090,192274
1006389,6287,83609,66481,41910,198287
1006390,34494,77140,96365,9884,217883
1006391,32660,12885,52471,90168,188184
1006392,93231,65214,67595,51065,277105
1006393,63415,96997,15572,52935,228919
1006394,56033,29670,84139,76611,246453
1006395,27203,61017,44493,36494,169207
1006396,55510,46005,57202,76919,235636
1006397,52516,31455,14144,62635,160750
1006398,54858,97607,35206,98266,285937
1006399,80833,37657,14388,88940,221818
1006400,67126,24703,20450,66592,178871
1006401,46910,47652,36124,51994,182680
1006402,2360,14919,95721,52785,165785
1006403,91448,51639,54968,31548,229603
1006404,89399,52735,40079,88838,271051
1006405,27081,77366,79193,30354,213994
1006406,18613,37129,13873,3184,72799
1006407,14720,116,101,49332,64269
1006408,81173,51376,80228,50818,263595
1006409,89452,13799,48190,49235,200676
1006410,20359,18510,20069,51728,110666
1006411,7195,22177,99789,96435,225596
1006412,14688,60555,89157,66778,231178
1006413,34024,19503,85157,41875,180559
1006414,97446,4367,60891,93555,256259
1006415,23579,56964,3491,99308,183342
1006416,25217,1515,882,34777,62391
1006417,31824,32630,87337,48256,200047
1006418,86766,59168,17971,64694,228599
1006419,17240,5798,93267,93013,209318
1006420,45179,36928,75703,22340,180150
1006421,63991,50308,99048,65443,278790
1006422,74165,75172,72607,60403,282347
1006423,38131,22933,59068,12258,132390
1006424,2148,294,3640,66002,72084
1006425,74504,57156,12421,1748,145829
1006426,88835,94673,28900,71245,283653
1006427,21320,84361,21372,77443,204496
1006428,97391,28318,48405,77374,251488
1006429,36064,97317,9905,76539,219825
1006430,77680,8638,38574,44648,169540
1006431,76025,14651,89563,62085,242324
1006432,51613,84892,16348,94191,247044
1006433,49529,1137,99178,13060,162904
1006434,21021,18629,27722,2783,70155
1006435,71783,56148,95363,58644,281938
1006436,97580,79433,54674,34663,266350
1006437,75048,38882,63070,86824,263824
1006438,7789,83675,52535,54208,198207
1006439,19297,67988,3462,44654,135401
1006440,82118,93103,10840,65241,251302
1006441,89335,30898,18014,90949,229196
1006442,24096,52813,3801,57939,138649
1006443,72664,4898,63525,58050,199137
1006444,72960,98234,18506,41527,231227
1006445,89638,97448,36567,32382,256035
1006446,62380,6395,26716,40422,135913
1006447,21605,34135,95966,60395,212101
1006448,12102,12102,77348,27167,128719
1006449,95333,31201,31060,52033,209627
1006450,29930,38567,30700,25762,124959
1006451,37062,71849,53361,10184,172456
1006452,18219,91154,75782,6505,191660
1006453,4788,7452,68439,40380,121059
1006454,87704,57630,15767,68170,229271
1006455,86981,81273,96388,52681,317323
1006456,35623,28231,77189,60796,201839
1006457,89104,28651,58401,22230,198386
1006458,21684,55055,55084,70916,202739
1006459,33567,65643,74548,3645,177403
1006460,87694,75710,32016,76318,271738
1006461,55289,40882,38721,35528,170420
1006462,71464,13686,99802,28698,213650
1006463,74001,72703,2716,36182,185602
1006464,69489,69215,61732,13008,213444
1006465,99222,46714,89427,74280,309643
1006466,30298,34887,67449,2662,135296
1006467,76217,51674,64094,96289,288274
1006468,38045,35381,79539,15979,168944
1006469,8,87798,63185,12263,163254
1006470,61414,87881,80069,68455,297819
1006471,25465,95888,78771,69992,270116
1006472,88146,72936,98229,90984,350295
1006473,332,56821,13599,27056,97808
1006474,3502,56741,56404,69666,186313
1006475,685,99024,55213,63235,218157
1006476,52653,65580,7302,42426,167961
1006477,62306,98340,32568,24756,217970
1006478,38781,5471,45050,7232,96534
1006479,73783,93581,31584,59472,258420
1006480,29207,98541,21233,65998,214979
1006481,150,89757,1567,45750,137224
1006482,26497,74134,10434,98842,209907
1006483,78771,97462,13641,14738,204612
1006484,28761,31761,86205,52705,199432
1006485,3476,45316,51423,84254,184469
1006486,65135,60663,59529,18793,204120
1006487,67136,12645,8181,30723,118685
1006488,25984,55839,89079,65747,236649
1006489,28075,90889,25408,88503,232875
1006490,60200,87024,74215,25498,246937
1006491,57974,18392,53350,96052,225768
1006492,57862,85646,58623,40530,242661
1006493,8479,11405,49415,24962,94261
1006494,18006,35845,5662,11771,71284
1006495,63528,26804,93321,63607,247260
1006496,10434,82212,47550,87683,227879
1006497,82568,92720,38992,41842,256122
1006498,11527,6420,92387,30182,140516
1006499,19362,56297,35118,78264,189041
1006500,71788,28896,72148,28365,201197
1006501,73109,30335,19895,19795,143134
1006502,40762,23653,94637,48805,207857
1006503,37165,45624,21932,56764,161485
1006504,93570,69714,93901,2993,260178
1006505,51340,99572,4225,78304,233441
1006506,50112,51087,39850,18154,159203
1006507,99032,17950,23198,19908,160088
1006508,55180,30874,76142,93296,255492
1006509,12542,52781,19690,94146,179159
1006510,55404,2841,69068,2304,129617
1006511,1765,79550,83730,46914,211959
1006512,23663,33642,13293,78437,149035
1006513,45285,53277,88019,49329,235910
1006514,88226,68739,70269,49815,277049
1006515,11863,15360,78120,32130,137473
1006516,9508,1328,15344,92600,118780
1006517,60317,48694,63192,80576,252779
1006518,95116,23426,32470,44773,195785
1006519,94054,21853,88456,79315,283678
1006520,73044,24525,41033,34116,172718
1006521,64959,48224,77442,26519,217144
1006522,77557,68186,91792,21349,258884
1006523,44771,57525,25730,91477,219503
1006524,38137,83544,58877,36727,217285
1006525,14045,46407,35905,48028,144385
1006526,97771,62034,46425,20993,227223
1006527,7379,89783,12195,7434,116791
1006528,43755,23045,88441,25426,180667
1006529,42205,86744,59964,24573,213486
1006530,11731,34596,86641,50239,183207
1006531,19452,40732,71369,49867,181420
1006532,63874,57961,90591,31550,243976
1006533,74736,36441,87084,21539,219800
1006534,68182,41362,57070,78710,245324
1006535,36741,39291,62878,27378,166288
1006536,36244,47115,48133,96896,228388
1006537,10977,31722,40684,15502,98885
1006538,41044,2468,84077,62721,190310
1006539,11618,1142,14109,97492,124361
1006540,159,64580,48354,14587,127680
1006541,44914,45515,85264,61478,237171
1006542,40649,57506,41112,72137,211404
1006543,14886,90045,33606,99902,238439
1006544,56019,53426,33898,75924,219267
1006545,20903,93558,28482,99160,242103
1006546,16006,33521,41337,7611,98475
1006547,79353,28634,52,20096,128135
1006548,45007,26041,21371,51911,144330
1006549,25745,9672,12850,54389,102656
1006550,32123,52241,23251,44321,151936
1006551,58403,49020,406,3044,110873
1006552,15006,90520,35823,16077,157426
1006553,46434,27249,59984,45051,178718
1006554,59521,33037,2461,54009,149028
1006555,63434,89786,51007,72559,276786
1006556,77241,6617,36165,2060,122083
1006557,68885,24562,54144,3030,150621
1006558,54041,8056,16954,3258,82309
1006559,83112,65421,8468,49173,206174
1006560,72547,49486,61157,74328,257518
1006561,38669,2811,31819,57475,130774
1006562,14930,4923,57713,25536,103102
1006563,12299,51455,39232,25941,128927
1006564,93447,24777,20299,35022,173545
1006565,56867,73450,74879,18812,224008
1006566,28137,79807,84931,63039,255914
1006567,91391,86275,84704,3727,266097
1006568,39524,67989,33947,90681,232141
1006569,95636,93193,92335,36764,317928
1006570,34939,4102,73103,24030,136174
1006571,5335,24093,89691,78836,197955
1006572,96822,30235,32298,61534,220889
1006573,64036,27569,97733,31107,220445
1006574,81047,37995,14006,73406,206454
1006575,94961,12735,88664,74810,271170
1006576,43675,75648,67870,81018,268211
1006577,8053,40010,32088,61574,141725
1006578,24845,36367,35144,11890,108246
1006579,56627,17113,1806,24276,99822
1006580,50946,17741,90797,58799,218283
1006581,90355,27221,69541,10422,197539
1006582,66254,11676,27758,42295,147983
1006583,58013,87996,77927,44482,268418
1006584,59903,54656,25088,65100,204747
1006585,17666,26940,92693,57233,194532
1006586,70169,63531,9888,6931,150519
1006587,91711,1772,41765,27662,162910
1006588,61551,64421,40463,37505,203940
1006589,72410,77887,62072,73908,286277
1006590,3795,21627,70449,16099,111970
1006591,23287,96322,30342,63632,213583
1006592,1353,41871,88869,89648,221741
1006593,31123,61411,99929,74489,266952
1006594,18851,35990,79960,92678,227479
1006595,34809,886,59112,31352,126159
1006596,23646,70159,96944,16622,207371
1006597,71379,28940,16971,18603,135893
1006598,29161,2505,85668,33354,150688
1006599,11131,7258,38990,50021,107400
1006600,48360,14112,45360,83062,190894
1006601,26707,90222,87001,97407,301337
1006602,95504,16139,65955,70739,248337
1006603,88735,4189,81369,78523,252816
1006604,26100,89318,59648,77963,253029
1006605,93264,69633,91931,18581,273409
1006606,1558,96019,84921,85020,267518
1006607,68900,18835,29793,84004,201532
1006608,27783,96841,74096,65611,264331
1006609,10809,25770,38835,89342,164756
1006610,33254,6258,14241,85398,139151
1006611,38639,6411,80777,12901,138728
1006612,27620,51979,17353,53303,150255
1006613,42067,72419,69798,26087,210371
1006614,42560,50270,42788,35598,171216
1006615,69551,86856,39766,59947,256120
1006616,42766,9774,53246,14433,120219
1006617,43348,58129,43000,37961,182438
1006618,73687,16634,68331,71250,229902
1006619,98453,62479,12025,7733,180690
1006620,21561,26514,76570,53249,177894
1006621,23574,64138,50477,79052,217241
1006622,37577,36124,20433,46012,140146
1006623,70508,27594,14987,66731,179820
1006624,41496,71067,54555,63091,230209
1006625,91604,32491,49186,5720,179001
1006626,23751,81463,8696,85444,199354
1006627,7762,33283,47125,89657,177827
1006628,62394,19926,33092,54220,169632
1006629,94113,68401,22733,62367,247614
1006630,71349,38898,15518,29699,155464
1006631,11168,34664,61318,34375,141525
1006632,72946,6661,42286,31680,153573
1006633,51645,81513,86599,63784,283541
1006634,94568,93315,35703,16360,239946
1006635,54528,23162,92359,68798,238847
1006636,25846,41485,20025,93276,180632
1006637,56931,29821,75818,87214,249784
1006638,76517,26642,3949,38376,145484
1006639,26325,62072,98362,29234,215993
1006640,13583,67633,44125,6630,131971
1006641,46611,16473,48591,26917,138592
1006642,44821,31765,54612,34685,165883
1006643,22136,63897,29095,7372,122500
1006644,8208,70477,35127,56576,170388
1006645,40458,33321,26235,60864,160878
1006646,2049,53526,93980,21952,171507
1006647,65696,17056,34493,20330,137575
1006648,28700,63283,26539,83901,202423
1006649,69540,77681,16975,53951,218147
1006650,8082,41890,88660,48223,186855
1006651,2081,6509,85954,72134,166678
1006652,18930,73971,51344,86233,230478
1006653,14762,37889,47405,82122,182178
1006654,87193,32738,47764,15082,182777
1006655,48241,71422,2684,23845,146192
1006656,76437,62796,6440,36039,181712
1006657,88597,83610,31894,97249,301350
1006658,51653,34519,29412,98854,214438
1006659,20146,84334,35324,61094,200898
1006660,12895,5525,25350,75107,118877
1006661,36491,66354,96392,8649,207886
1006662,96360,17246,87534,61210,262350
1006663,42436,91653,35648,7549,177286
1006664,38803,10469,3376,62795,115443
1006665,17094,72030,76930,71828,237882
1006666,45265,75933,53323,31281,205802
1006667,51608,77324,23121,48362,200415
1006668,32377,17442,84957,67240,202016
1006669,51284,56685,37955,72917,218841
1006670,26242,31573,38204,59376,155395
1006671,39237,90028,12937,11081,153283
1006672,12585,66062,41442,82748,202837
1006673,37953,44368,44465,44262,171048
1006674,70753,38344,43377,60575,213049
1006675,63591,58883,75786,15775,214035
1006676,99142,48476,6347,23985,177950
1006677,32020,23045,3755,89546,148366
1006678,88794,99741,89179,16202,293916
1006679,80761,54430,9385,92451,237027
1006680,81516,35269,53566,25308,195659
1006681,52800,20483,65757,17475,156515
1006682,13711,20575,38900,13242,86428
1006683,88193,15347,27320,761,131621
1006684,21997,57427,81050,47332,207806
1006685,85130,96198,48326,19371,249025
1006686,59582,50251,24081,91711,225625
1006687,39102,86780,66107,37281,229270
1006688,16466,95655,88847,35748,236716
1006689,27199,47596,67116,3872,145783
1006690,67459,16118,89541,25663,198781
1006691,61706,59691,75268,96205,292870
1006692,92333,75150,30702,75776,273961
1006693,97179,54977,86535,28534,267225
1006694,81955,61922,65675,99724,309276
1006695,92164,47248,82909,45510,267831
1006696,1132,90615,87623,88934,268304
1006697,93228,57532,37532,36931,225223
1006698,14625,1146,38335,26918,81024
1006699,1214,96790,35871,26668,160543
1006700,34617,99780,44615,60590,239602
1006701,45323,2812,41219,55834,145188
1006702,8675,61544,49695,93451,213365
1006703,54913,55331,45274,17538,173056
1006704,28920,86270,60947,33011,209148
1006705,49490,37931,26365,60006,173792
1006706,81602,97735,73847,24626,277810
1006707,45350,54384,74733,28331,202798
1006708,86717,51054,97946,78630,314347
1006709,22967,63631,45653,50561,182812
1006710,56457,9229,88823,6968,161477
1006711,2010,82375,63645,21991,170021
1006712,3538,62939,35163,53873,155513
1006713,47472,47677,19761,10068,124978
1006714,52210,15488,27117,61193,156008
1006715,86857,12794,65669,97081,262401
1006716,29617,32850,35098,77889,175454
1006717,8441,2683,12351,18113,41588
1006718,22633,11012,30259,68102,132006
1006719,43823,7923,49303,51927,152976
1006720,96915,35036,98181,76365,306497
1006721,13394,70183,77890,10577,172044
1006722,60010,88722,39411,50126,238269
1006723,43296,65873,20199,78895,208263
1006724,2908,49922,82327,67165,202322
1006725,84414,59493,98730,51473,294110
1006726,39119,15254,29115,4458,87946
1006727,48293,23745,47286,25464,144788
1006728,98940,88955,39595,80348,307838
1006729,18218,62118,68266,9614,158216
1006730,49723,50060,26626,88702,215111
1006731,97606,46959,21474,79138,245177
1006732,61126,62742,22385,99859,246112
1006733,13313,17494,12120,15391,58318
1006734,16220,44806,86718,76843,224587
1006735,89288,83646,45030,46553,264517
1006736,54374,38841,68676,79074,240965
1006737,27952,69188,41208,3668,142016
1006738,71911,13823,5783,97396,188913
1006739,12564,80793,12243,95354,200954
1006740,13111,61613,14339,45534,134597
1006741,93658,76567,62914,67588,300727
1006742,97379,97329,2340,40088,237136
1006743,50734,14054,59167,8197,132152
1006744,39360,39796,46647,36001,161804
1006745,61722,6639,79759,82742,230862
1006746,72921,4033,94830,1321,173105
1006747,91128,23104,33028,98258,245518
1006748,93046,56572,80874,89099,319591
1006749,48219,38755,30678,31108,148760
1006750,75516,27081,28303,17041,147941
1006751,58136,23725,89238,41330,212429
1006752,60052,38828,60301,82829,242010
1006753,73832,12188,33566,62628,182214
1006754,67275,69706,48779,43387,229147
1006755,31661,88067,67948,94939,282615
1006756,96620,27905,37173,47395,209093
1006757,59633,44725,88754,81046,274158
1006758,59240,70501,16802,3656,150199
1006759,53244,10918,59618,79282,203062
1006760,54292,18094,57030,83950,213366
1006761,58369,918,70822,38380,168489
1006762,92179,60705,64563,86937,304384
1006763,79384,51557,82515,83695,297151
1006764,81839,64205,14196,91843,252083
1006765,68724,2624,75,39331,110754
1006766,33184,50994,34846,38553,157577
1006767,73027,63138,79899,38552,254616
1006768,43986,30017,95466,22326,191795
1006769,45902,77341,53702,34636,211581
1006770,62508,70540,79858,22102,235008
1006771,50661,68656,89906,97046,306269
1006772,65555,59655,45860,25843,196913
1006773,71025,94536,36831,25924,228316
1006774,29693,99777,28455,64077,222002
1006775,78561,65854,85069,39008,268492
1006776,72389,944,15703,68153,157189
1006777,18741,11669,10960,79451,120821
1006778,41491,18070,96510,2277,158348
1006779,99321,75155,37207,96014,307697
1006780,36916,18876,5973,68207,129972
1006781,90449,52745,35223,55867,234284
1006782,29229,40263,16462,26398,112352
1006783,34689,97168,20066,67791,219714
1006784,41557,65783,94230,21613,223183
1006785,73064,6502,14720,84753,179039
1006786,94204,89171,42031,29681,255087
1006787,98499,13308,22898,42206,176911
1006788,84684,2437,21397,86478,194996
1006789,50200,92024,37530,41463,221217
1006790,84066,70727,62711,43505,261009
1006791,96716,65095,29226,77438,268475
1006792,23815,59672,81049,80265,244801
1006793,73959,70494,36495,82492,263440
1006794,66697,33163,14535,72528,186923
1006795,72917,14083,99234,79124,265358
1006796,72918,75619,70486,75356,294379
1006797,21656,9192,13687,25684,70219
1006798,54394,47549,41535,13359,156837
1006799,72126,32775,45882,17776,168559
1006800,91871,86676,42972,50243,271762
1006801,28318,82591,64745,48157,223811
1006802,54288,39256,15851,79758,189153
1006803,1339,43115,88146,3888,136488
1006804,93698,43082,86474,93042,316296
1006805,5627,64927,5280,22455,98289
1006806,32353,76603,77129,76776,262861
1006807,92820,49414,15717,4071,162022
1006808,96914,51337,1598,30334,180183
1006809,84278,87119,80775,38386,290558
1006810,58864,11936,59824,40606,171230
1006811,61840,6482,80515,71808,220645
1006812,28034,40336,95164,89873,253407
1006813,89492,98173,18275,29001,234941
1006814,99199,40579,96771,8796,245345
1006815,53434,28800,33156,15538,130928
1006816,51840,46403,1341,20289,119873
1006817,97043,2150,31421,30713,161327
1006818,12690,53993,71833,82671,221187
1006819,5429,88904,71730,27382,193445
1006820,5594,2780,50654,22661,81689
1006821,87594,88745,12352,2524,191215
1006822,86991,76296,60622,2000,225909
1006823,55678,15079,89125,37882,197764
1006824,33555,26765,70933,45170,176423
1006825,55617,63823,52775,1470,173685
1006826,66974,50444,38068,31416,186902
1006827,42512,56089,4540,45873,149014
1006828,32675,56453,47256,96414,232798
1006829,53990,49036,46861,65848,215735
1006830,30743,332,56063,28697,115835
1006831,73626,77959,21477,77094,250156
1006832,32773,44541,52486,65064,194864
1006833,3171,57275,17672,49378,127496
1006834,90370,58259,57788,73212,279629
1006835,97873,19935,20776,69488,208072
1006836,11567,97843,76303,18965,204678
1006837,76794,84863,21883,38656,222196
1006838,50740,37828,35035,97272,220875
1006839,60996,67643,56205,90941,275785
1006840,14062,45688,26102,84255,170107
1006841,17333,83330,44677,24547,169887
1006842,50899,11200,87820,53383,203302
1006843,34630,62883,71238,16606,185357
1006844,45357,23973,16558,92320,178208
1006845,15106,28838,15464,58589,117997
1006846,57810,86524,51269,45064,240667
1006847,94121,45623,15184,59517,214445
1006848,91931,4991,26657,20295,143874
1006849,92762,85876,53251,27842,259731
1006850,7580,16113,78919,66818,169430
1006851,10197,76262,31523,97972,215954
1006852,15257,81905,83362,35914,216438
1006853,91363,85549,84343,26202,287457
1006854,96143,69726,76642,57702,300213
1006855,73504,8606,4491,78590,165191
1006856,75229,17586,82527,23383,198725
1006857,25130,11843,61586,48797,147356
1006858,52232,43122,32531,5022,132907
1006859,85006,66982,904,714,153606
1006860,80375,71668,22313,26378,200734
1006861,52382,86894,205,62917,202398
1006862,77343,22155,84112,29168,212778
1006863,48024,48765,23489,12790,133068
1006864,27624,6823,28904,82741,146092
1006865,91393,10085,62463,61326,225267
1006866,34969,40784,74859,82795,233407
1006867,60188,25210,20996,41891,148285
1006868,12494,22862,39104,50748,125208
1006869,2644,13540,55859,87467,159510
1006870,20409,83178,65848,58673,228108
1006871,58977,81399,12896,6735,160007
1006872,62739,64995,64223,91961,283918
1006873,22339,35183,92368,29279,179169
1006874,38772,81420,93732,57075,270999
1006875,99832,970,83709,64739,249250
1006876,24414,72911,47002,53143,197470
1006877,52997,45143,20729,94765,213634
1006878,75112,59438,35881,43159,213590
1006879,71350,68181,9569,20874,169974
1006880,17039,45317,30806,49332,142494
1006881,34154,29109,51156,37405,151824
1006882,62297,36869,15159,89442,203767
1006883,32567,7667,90557,88776,219567
1006884,95885,83701,28248,68283,276117
1006885,85066,58217,82332,52074,277689
1006886,80305,97518,58743,73089,309655
1006887,98334,89298,55629,95901,339162
1006888,12637,49445,18412,18569,99063
1006889,52349,21483,88654,5039,167525
1006890,72087,67718,22975,81151,243931
1006891,30959,43515,14989,23318,112781
1006892,44821,57085,55434,31148,188488
1006893,37295,51065,48552,93256,230168
1006894,6333,79358,21581,9630,116902
1006895,58826,56680,13630,73337,202473
1006896,19139,99115,88303,66817,273374
1006897,37130,37933,22663,70636,168362
1006898,26359,26316,13805,84103,150583
1006899,21967,53922,95127,94544,265560
1006900,47470,40588,72964,48430,209452
1006901,15996,18164,73144,3736,111040
1006902,2576,42533,27192,98828,171129
1006903,82142,54393,53175,85451,275161
1006904,58905,24897,941,85692,170435
1006905,25533,33116,44542,27077,130268
1006906,42592,38393,15530,52797,149312
1006907,325,33940,95374,68012,197651
1006908,82443,34317,5816,58531,181107
1006909,13145,17804,8429,8366,47744
1006910,22545,69719,50353,1481,144098
1006911,76023,51167,95186,8557,230933
1006912,70324,56810,73020,93520,293674
1006913,58406,79165,74043,52949,264563
1006914,10143,27061,4813,58034,100051
1006915,77319,64248,3177,58234,202978
1006916,31634,11912,46525,47429,137500
1006917,37367,57400,16270,21346,132383
1006918,29924,25044,80906,10656,146530
1006919,13853,21237,75825,3810,114725
1006920,3384,4813,14569,50923,73689
1006921,52313,74696,89769,48243,265021
1006922,4889,21736,87900,28400,142925
1006923,40345,62502,22711,8523,134081
1006924,65851,96192,37321,11766,211130
1006925,68315,5486,52845,41060,167706
1006926,28088,45265,53537,92590,219480
1006927,9690,88664,75320,45806,219480
1006928,24971,22988,49050,39930,136939
1006929,31626,32070,71355,96759,231810
1006930,60644,76200,36259,5646,178749
1006931,85923,91308,76202,21954,275387
1006932,62058,77900,73833,57805,271596
1006933,91206,54607,77010,36547,259370
1006934,60011,35414,27122,63782,186329
1006935,74500,19813,13612,39301,147226
1006936,76430,93986,75053,31203,276672
1006937,85565,54378,55026,72748,267717
1006938,30958,9090,30793,24070,94911
1006939,38285,60405,12865,65580,177135
1006940,87113,27064,42589,79296,236062
1006941,46145,33934,55392,6291,141762
1006942,52023,49593,13529,23895,139040
1006943,61868,77537,73183,13276,225864
1006944,70613,44812,52695,64529,232649
1006945,16145,14783,39785,63809,134522
1006946,28589,96,82806,63984,175475
1006947,90645,13332,89482,42096,235555
1006948,9653,77765,75427,91701,254546
1006949,90320,35805,88215,20833,235173
1006950,31393,49255,17596,2129,100373
1006951,93033,90334,3176,14310,200853
1006952,4146,74975,17810,39621,136552
1006953,87,24271,76204,51438,152000
1006954,4409,82959,2103,62483,151954
1006955,99437,68509,50675,83051,301672
1006956,78058,33926,26190,89271,227445
1006957,195,33628,27457,44370,105650
1006958,35907,38578,56260,44446,175191
1006959,74934,34208,63976,20983,194101
1006960,10039,44295,20800,2565,77699
1006961,33087,19456,45754,38689,136986
1006962,4414,95430,52445,57160,209449
1006963,73963,99036,77286,35569,285854
1006964,56550,27919,57926,45441,187836
1006965,88449,6996,31832,64338,191615
1006966,63784,22406,58090,83555,227835
1006967,38107,28959,44622,98635,210323
1006968,58008,86850,8688,97101,250647
1006969,85147,99271,64283,19457,268158
1006970,76017,45268,64984,31549,217818
1006971,60351,43692,41133,53637,198813
1006972,54069,77986,52306,6226,190587
1006973,59726,71532,22134,65814,219206
1006974,53341,13639,63858,16085,146923
1006975,42633,88637,32366,9568,173204
1006976,21517,68782,99149,19151,208599
1006977,54935,19964,22861,95455,193215
1006978,40456,26670,86972,3080,157178
1006979,40003,2548,85429,81598,209578
1006980,2932,82715,40580,58781,185008
1006981,56871,73481,39449,99439,269240
1006982,86671,61843,54074,47898,250486
1006983,93932,25354,66797,73488,259571
1006984,99966,91678,86968,11578,290190
1006985,51710,13384,83620,48313,197027
1006986,30960,47874,81595,29389,189818
1006987,43054,9272,95248,23241,170815
1006988,90369,58592,28017,49107,226085
1006989,82728,71964,86769,75040,316501
1006990,43003,64902,24996,45782,178683
1006991,1186,81223,11674,85236,179319
1006992,79815,85832,39489,7291,212427
1006993,29273,62950,47303,98642,238168
1006994,75878,88245,15273,30397,209793
1006995,53016,21652,37046,29451,141165
1006996,99263,93032,83633,91063,366991
1006997,33252,27255,47355,13451,121313
1006998,16601,35626,31527,49526,133280
1006999,7886,60707,28750,58690,156033
1007000,45488,54174,83417,57170,240249
1007001,84867,46518,16342,83753,231480
1007002,80863,65993,2089,56418,205363
1007003,72483,33956,42232,97189,245860
1007004,5204,20431,38459,6324,70418
1007005,11576,71128,45983,86077,214764
1007006,2108,86497,48038,90595,227238
1007007,67409,63790,62690,35586,229475
1007008,96402,65974,76576,65944,304896
1007009,40289,31775,63996,24207,160267
1007010,94781,36724,41779,36228,209512
1007011,71823,79932,38438,25395,215588
1007012,99120,9974,81566,22696,213356
1007013,66862,53044,69592,6364,195862
1007014,14396,35053,77169,40584,167202
1007015,13804,99413,33772,91953,238942
1007016,31758,27500,32916,79820,171994
1007017,50669,8421,18434,99701,177225
1007018,12283,40847,85416,72843,211389
1007019,37828,94437,68817,71983,273065
1007020,86533,72495,60536,45977,265541
1007021,2965,47643,19601,94328,164537
1007022,83794,83800,47786,89428,304808
1007023,6888,18559,42679,6601,74727
1007024,80920,24098,13734,18373,137125
1007025,92509,91276,8698,71817,264300
1007026,93991,67892,39737,13658,215278
1007027,29276,86735,28056,76673,220740
1007028,25389,71224,31064,99828,227505
1007029,69064,30474,90385,57778,247701
1007030,1470,91105,58989,39038,190602
1007031,67866,51543,73064,35344,227817
1007032,1302,75858,922,95092,173174
1007033,29304,66439,89196,64038,248977
1007034,44937,74043,90079,83191,292250
1007035,51034,34916,23298,1591,110839
1007036,3503,99121,77610,33619,213853
1007037,82850,89695,12598,82998,268141
1007038,20649,9722,67933,37735,136039
1007039,3264,60386,65079,82327,211056
1007040,56675,66304,99116,99625,321720
1007041,39325,84413,97654,32841,254233
1007042,35291,63028,80554,27747,206620
1007043,25869,30424,95519,64763,216575
1007044,55730,51279,91697,85592,284298
1007045,13754,33754,40835,55762,144105
1007046,9151,90911,30578,15467,146107
1007047,10534,20879,58780,15088,105281
1007048,70950,98994,53632,54499,278075
1007049,96783,24228,10988,16410,148409
1007050,12492,80842,64655,82619,240608
1007051,21633,13281,6781,53709,95404
1007052,13797,85276,38185,44552,181810
1007053,32069,16441,14771,19608,82889
1007054,98693,76455,45281,54462,274891
1007055,53768,68716,46459,61353,230296
1007056,62586,68834,36806,79126,247352
1007057,1789,44856,83038,67215,196898
1007058,64731,96687,93954,80715,336087
1007059,17664,28952,25304,16444,88364
1007060,45017,39816,89317,60228,234378
1007061,70200,1737,57475,36499,165911
1007062,20169,34958,97278,99398,251803
1007063,86961,56957,82326,12864,239108
1007064,71418,5278,82007,85256,243959
1007065,72993,9061,17701,16046,115801
1007066,35639,79768,53450,93003,261860
1007067,53591,46550,86877,2061,189079
1007068,17759,53895,47656,79669,198979
1007069,37812,81477,24878,89339,233506
1007070,90087,46651,78363,81374,296475
1007071,18644,71271,35183,47753,172851
1007072,89982,69315,3856,32905,196058
1007073,90903,26401,59184,82806,259294
1007074,9442,37605,67588,16681,131316
1007075,55051,35832,34301,1928,127112
1007076,48694,84396,69057,63191,265338
1007077,44295,82263,93263,34310,254131
1007078,48352,66424,95827,93618,304221
1007079,1288,34829,17115,47176,100408
1007080,24150,50661,8737,3908,87456
1007081,97128,70664,46608,36663,251063
1007082,87171,23335,63590,55060,229156
1007083,78014,98378,89179,44124,309695
1007084,58610,54595,1077,70421,184703
1007085,89667,46978,9255,64909,210809
1007086,49733,88317,37327,82914,258291
1007087,9712,64484,62671,46829,183696
1007088,43087,6705,8587,9687,68066
1007089,13886,24658,21400,83850,143794
1007090,84412,38168,87152,80487,290219
1007091,36874,95400,60296,55916,248486
1007092,26643,80893,13467,74309,195312
1007093,23327,53971,11647,25348,114293
1007094,86866,70228,88895,86286,332275
1007095,29251,97224,95592,19804,241871
1007096,36354,69987,24168,48789,179298
1007097,12358,35410,33207,71544,152519
1007098,63157,61033,14385,41561,180136
1007099,19102,12600,50461,23317,105480
1007100,22675,6428,37713,39798,106614
1007101,16483,9159,97744,29314,152700
1007102,96673,61760,31836,67290,257559
1007103,98781,1101,24228,75261,199371
1007104,13418,70868,67028,63231,214545
1007105,73611,6578,93321,91717,265227
1007106,93011,65913,82123,51011,292058
1007107,9098,37998,88456,88377,223929
1007108,73807,35959,14605,49810,174181
1007109,70002,46385,76888,20927,214202
1007110,89358,52809,67123,30847,240137
1007111,63851,41607,6360,90070,201888
1007112,65003,53749,7638,20202,146592
1007113,2437,31748,18624,50998,103807
1007114,53362,69205,8908,19128,150603
1007115,99602,71054,40151,56596,267403
1007116,54438,20281,5911,70582,151212
1007117,93926,81707,90058,83025,348716
1007118,65555,18658,2481,67999,154693
1007119,62322,41333,90603,23647,217905
1007120,62302,35193,45413,29834,172742
1007121,53515,37644,7962,78013,177134
1007122,63361,63073,75376,76078,277888
1007123,9076,41966,33011,7356,91409
1007124,55833,51810,7115,497,115255
1007125,95341,98991,63150,20308,277790
1007126,39775,21738,81537,17094,160144
1007127,69973,35801,13684,51633,171091
1007128,19778,57728,85741,3619,166866
1007129,35003,44130,68570,53532,201235
1007130,68281,85674,23821,86860,264636
1007131,98670,19467,24183,72214,214534
1007132,7155,23495,58475,88772,177897
1007133,48043,50766,54139,71129,224077
1007134,19565,8840,98125,17661,144191
1007135,43861,8627,92151,31968,176607
1007136,56925,41133,27036,26281,151375
1007137,1307,20315,93526,47687,162835
1007138,14373,19388,53431,96964,184156
1007139,95797,79015,82105,54562,311479
1007140,72781,47118,77820,54383,252102
1007141,58141,75552,62734,25898,222325
1007142,36734,79613,44155,15035,175537
1007143,80481,86645,72238,11847,251211
1007144,12581,82472,56973,83670,235696
1007145,47370,91954,73412,9387,222123
1007146,12143,64685,4959,25831,107618
1007147,86317,4482,80217,21063,192079
1007148,53378,4748,62843,96833,217802
1007149,47756,50127,35652,20399,153934
1007150,67597,22157,21822,8585,120161
1007151,27019,60383,74534,13477,175413
1007152,54284,54532,48689,56127,213632
1007153,19548,20985,76028,60969,177530
1007154,33036,99971,23247,9852,166106
1007155,16404,23464,46668,77037,163573
1007156,7801,42949,50985,96615,198350
1007157,32211,72639,64574,98755,268179
1007158,45849,91531,86240,22533,246153
1007159,38126,22523,6055,99447,166151
1007160,58992,21229,26470,94743,201434
1007161,77797,57776,59954,41059,236586
1007162,86124,39864,28354,93998,248340
1007163,90241,54056,14602,77199,236098
1007164,59703,97770,65978,29089,252540
1007165,86256,25181,18221,98046,227704
1007166,50622,39168,18744,23434,131968
1007167,70625,6915,66544,37098,181182
1007168,67399,63970,650,29482,161501
1007169,4169,79725,14451,37531,135876
1007170,95658,19457,36202,1647,152964
1007171,32621,45493,95635,17284,191033
1007172,85283,47798,81070,87316,301467
1007173,40581,30827,96861,85511,253780
1007174,88337,97968,70223,46965,303493
1007175,11100,83654,2924,65716,163394
1007176,52026,38832,85676,9292,185826
1007177,12888,59862,76665,14355,163770
1007178,31418,719,690,53303,86130
1007179,59627,56096,56191,6361,178275
1007180,38395,42071,8971,36403,125840
1007181,15026,50794,5307,66689,137816
1007182,72890,4597,7142,52063,136692
1007183,15355,99093,95771,31125,241344
1007184,1302,37031,40185,67825,146343
1007185,40934,88198,55242,67110,251484
1007186,45678,41659,24191,56790,168318
1007187,77564,52764,56842,43711,230881
1007188,18027,58506,45061,21361,142955
1007189,67265,70275,43888,86691,268119
1007190,80435,4484,32049,28305,145273
1007191,14489,55364,88223,11197,169273
1007192,64755,99422,4661,79405,248243
1007193,36396,54738,7795,75257,174186
1007194,82796,83609,22802,52166,241373
1007195,26290,67812,9710,61260,165072
1007196,7343,81056,21915,96340,206654
1007197,81673,55873,90254,10062,237862
1007198,81172,73328,94174,48131,296805
1007199,59903,872,45803,98505,205083
1007200,21316,6094,38432,34792,100634
1007201,44876,38967,92016,36330,212189
1007202,58610,89126,58973,78656,285365
1007203,74980,58211,19067,33515,185773
1007204,1122,6429,67849,77518,152918
1007205,18338,59795,55175,88539,221847
1007206,56669,31621,14140,39505,141935
1007207,68157,63698,30208,42952,205015
1007208,66987,27549,32954,20808,148298
1007209,64707,20155,14468,11539,110869
1007210,22338,60201,35273,85166,202978
1007211,6000,55689,85987,12870,160546
1007212,34741,52344,89539,25053,201677
1007213,9108,64871,18927,71021,163927
1007214,15005,76822,95397,73418,260642
1007215,58057,94072,30662,35082,217873
1007216,29126,80119,44665,27157,181067
1007217,87744,15673,56196,473,160086
1007218,67415,21018,13357,14749,116539
1007219,12506,15011,14010,5694,47221
1007220,14516,47059,67745,86787,216107
1007221,22764,16341,13807,25400,78312
1007222,85657,31577,38392,167,155793
1007223,18102,17715,69908,73074,178799
1007224,12528,23979,80889,58501,175897
1007225,71855,13233,86508,6872,178468
1007226,77258,73319,48153,71478,270208
1007227,84579,22377,17287,39369,163612
1007228,98582,51433,17541,71903,239459
1007229,69284,84103,37370,52609,243366
1007230,88103,67001,31916,65796,252816
1007231,18990,49158,43045,28056,139249
1007232,3541,18354,4539,8756,35190
1007233,23662,48188,49874,28608,150332
1007234,98230,21184,31031,29787,180232
1007235,1034,83001,46529,44293,174857
1007236,62833,64127,63928,14997,205885
1007237,97595,69507,22053,37699,226854
1007238,69843,92027,56976,86731,305577
1007239,41572,42032,13955,91994,189553
1007240,24764,82368,47003,42785,196920
1007241,99002,10638,27740,83917,221297
1007242,41565,69025,99100,42401,252091
1007243,54558,66510,58517,75890,255475
1007244,31430,59999,52129,73411,216969
1007245,48871,57081,72571,80539,259062
1007246,66259,13519,27575,96201,203554
1007247,51757,78861,52634,50531,233783
1007248,26830,45967,38317,90682,201796
1007249,34069,66028,9402,79603,189102
1007250,15883,70019,97724,75084,258710
1007251,16025,97723,14374,43695,171817
1007252,65585,5864,50807,32992,155248
1007253,72388,26196,78306,56219,233109
1007254,21595,20302,35569,76892,154358
1007255,62115,79043,32880,91099,265137
1007256,16391,58772,72135,87035,234333
1007257,42606,40407,91190,71895,246098
1007258,8005,27461,47278,43744,126488
1007259,66998,53110,57382,17116,194606
1007260,8433,13109,61515,50278,133335
1007261,3183,91817,78978,40642,214620
1007262,29166,37997,28871,49888,145922
1007263,92515,35849,55037,73125,256526
1007264,97500,90258,20498,79939,288195
1007265,83855,91788,7342,57785,240770
1007266,61721,55059,94091,42198,253069
1007267,9603,79970,26629,41599,157801
1007268,23552,17103,92835,85225,218715
1007269,37964,80674,93752,17736,230126
1007270,17165,84003,87187,2220,190575
1007271,40290,18878,77947,49251,186366
1007272,8473,24307,28225,51761,112766
1007273,21025,45814,74050,65482,206371
1007274,183,68143,78620,2652,149598
1007275,51615,58875,39423,39200,189113
1007276,35827,9468,38154,27577,111026
1007277,29260,74942,55310,48683,208195
1007278,90477,83724,21490,96693,292384
1007279,76239,97682,50031,37687,261639
1007280,75062,41136,88079,96176,300453
1007281,13999,38239,69220,11866,133324
1007282,93408,50284,91232,21667,256591
1007283,42094,98514,76163,76627,293398
1007284,97702,34736,77169,12493,222100
1007285,97903,73979,54331,86682,312895
1007286,19638,71095,60656,53226,204615
1007287,55629,38618,29461,33956,157664
1007288,79071,80163,19506,72878,251618
1007289,2316,23580,92726,74115,192737
1007290,45558,28126,53218,94120,221022
1007291,48257,42957,85682,43513,220409
1007292,38549,98860,84915,80406,302730
1007293,33189,12931,77537,6065,129722
1007294,12771,9617,99510,88052,209950
1007295,90715,77540,29491,95988,293734
1007296,93904,38279,59230,29063,220476
1007297,20540,95241,79193,83266,278240
1007298,9272,26623,31938,62757,130590
1007299,27709,70111,28070,35261,161151
1007300,3934,30960,57585,15817,108296
1007301,91622,96184,42594,88130,318530
1007302,29896,47187,98323,9668,185074
1007303,51658,4927,37736,90880,185201
1007304,61353,55248,74204,85486,276291
1007305,25195,54691,28029,46990,154905
1007306,48795,44020,80771,13586,187172
1007307,65644,96113,53252,44,215053
1007308,86363,94210,19712,92417,292702
1007309,31823,56504,34357,73897,196581
1007310,46008,52999,59259,87173,245439
1007311,28891,28756,92641,27690,177978
1007312,6309,72726,72878,61647,213560
1007313,55018,4053,65130,47966,172167
1007314,21553,40740,56932,60479,179704
1007315,92263,68557,21811,90498,273129
1007316,51764,46242,45772,43945,187723
1007317,94731,95707,47063,91276,328777
1007318,96598,53113,34674,52299,236684
1007319,22645,77162,5859,25015,130681
1007320,93692,36355,3513,41558,175118
1007321,13515,16014,68104,69924,167557
1007322,77748,69971,84200,43291,275210
1007323,5075,15135,85080,37020,142310
1007324,46107,66468,43659,63583,219817
1007325,49092,76931,15944,29999,171966
1007326,62454,67116,96782,39483,265835
1007327,10724,3673,55857,53224,123478
1007328,38915,47733,8876,95220,190744
1007329,70165,71366,65115,77885,284531
1007330,64412,86385,75976,78979,305752
1007331,83608,21155,2859,44172,151794
1007332,32643,22090,36701,15750,107184
1007333,79002,81037,26163,64396,250598
1007334,84166,21947,75537,5187,186837
1007335,81659,37400,58434,70138,247631
1007336,64581,18479,50912,62138,196110
1007337,18135,57952,760,92941,169788
1007338,35280,99089,517,90917,225803
1007339,32003,49462,195,10474,92134
1007340,74450,66892,80234,46423,267999
1007341,59950,58380,41216,65214,224760
1007342,56784,77761,26007,45886,206438
1007343,7191,44363,44386,60483,156423
1007344,49412,92465,39184,97480,278541
1007345,84607,47103,40436,63875,236021
1007346,11450,81915,75347,25392,194104
1007347,15758,76652,41697,81142,215249
1007348,73605,12179,42629,56028,184441
1007349,94563,60200,59182,9293,223238
1007350,8581,61705,21770,11511,103567
1007351,37177,13661,9731,11978,72547
1007352,7791,15094,99745,80693,203323
1007353,68735,57173,884,19244,146036
1007354,65469,647,75229,13172,154517
1007355,58148,32427,86534,53084,230193
1007356,28563,7431,51373,77656,165023
1007357,87658,99472,70968,96606,354704
1007358,21381,5429,14712,9632,51154
1007359,83235,77292,79436,64170,304133
1007360,39655,60929,34244,69192,204020
1007361,4983,33949,59945,46609,145486
1007362,32567,83840,8060,65821,190288
1007363,39714,61209,59068,64941,224932
1007364,96264,77683,57259,95587,326793
1007365,32752,83083,42811,15197,173843
1007366,74476,24113,97900,42206,238695
1007367,23698,44218,96539,34831,199286
1007368,38040,72002,70611,4547,185200
1007369,82315,69270,11785,19107,182477
1007370,75583,93777,92573,5550,267483
1007371,93593,53904,728,43391,191616
1007372,93947,95019,60775,98431,348172
1007373,9035,13757,35323,80121,138236
1007374,10012,87028,8255,17605,122900
1007375,62,57389,78735,47325,183511
1007376,44953,22351,90146,2798,160248
1007377,38936,38859,48639,56607,183041
1007378,34968,9388,52075,25128,121559
1007379,6717,61322,33762,79407,181208
1007380,27996,3270,4657,80310,116233
1007381,42468,50790,14213,76631,184102
1007382,16424,12873,66929,39723,135949
1007383,54953,91014,12549,40544,199060
1007384,66130,33605,14634,87821,202190
1007385,2075,86865,5351,95926,190217
1007386,93321,53627,52999,73667,273614
1007387,69635,33326,26637,44118,173716
1007388,49711,55626,56515,53766,215618
1007389,70556,57230,88135,51454,267375
1007390,15184,49942,40004,70329,175459
1007391,18429,25221,93287,17263,154200
1007392,99327,90336,8951,65674,264288
1007393,98987,20376,91166,17095,227624
1007394,61307,83727,12450,48982,206466
1007395,27212,83914,78487,13290,202903
1007396,93921,58657,13910,60055,226543
1007397,45111,91732,3421,54610,194874
1007398,58450,26080,37337,81253,203120
1007399,95347,31349,84994,42524,254214
1007400,24764,62217,20801,98182,205964
1007401,82738,90131,99917,48482,321268
1007402,92964,68187,39910,77750,278811
1007403,53258,5735,60987,6341,126321
1007404,5820,51367,78803,93198,229188
1007405,15359,58752,59457,14277,147845
1007406,47335,44717,41234,66810,200096
1007407,82373,20773,22039,26763,151948
1007408,56486,10696,89022,13229,169433
1007409,71116,43821,9395,6741,131073
1007410,25266,39303,76384,39341,180294
1007411,73079,53734,30173,83848,240834
1007412,75391,45158,42029,78452,241030
1007413,31007,29953,53104,64994,179058
1007414,95492,87346,74238,70568,327644
1007415,52322,26474,34503,73808,187107
1007416,18255,44352,11019,18748,92374
1007417,26091,47741,61981,29172,164985
1007418,92434,69126,15053,8262,184875
1007419,30237,10176,77312,9098,126823
1007420,7204,26765,85854,97927,217750
1007421,15684,35195,44777,77948,173604
1007422,97807,55777,93503,43757,290844
1007423,83624,49904,10484,57800,201812
1007424,66803,4136,37245,46522,154706
1007425,1698,59812,67067,40495,169072
1007426,1660,94433,33181,63082,192356
1007427,76957,78296,32941,36588,224782
1007428,68924,72342,3693,97986,242945
1007429,57075,65549,10404,15047,148075
1007430,39226,23659,1049,11289,75223
1007431,47469,59265,80834,14086,201654
1007432,38491,25967,97414,75140,237012
1007433,1445,71185,50901,35164,158695
1007434,44414,97338,55000,98092,294844
1007435,83583,3402,87177,12140,186302
1007436,93142,75094,74620,55244,298100
1007437,31935,69105,41282,31379,173701
1007438,22817,86496,6341,60593,176247
1007439,81924,65083,36302,93549,276858
1007440,61449,35025,48670,26289,171433
1007441,59187,9946,3964,32975,106072
1007442,64278,67265,52784,17162,201489
1007443,42149,13505,41303,66966,163923
1007444,31836,4350,37363,98602,172151
1007445,64502,67632,52256,44362,228752
1007446,81588,15613,98355,44741,240297
1007447,78530,16044,49661,88196,232431
1007448,53173,31522,19947,31263,135905
1007449,38910,25337,7625,96117,167989
1007450,19382,84588,20012,39879,163861
1007451,60329,72022,14531,94406,241288
1007452,14131,36867,32313,5927,89238
1007453,82801,4625,29843,5583,122852
1007454,57804,72791,75172,43080,248847
1007455,17998,22912,30865,60745,132520
1007456,13784,27563,20214,71767,133328
1007457,98294,54697,32092,51938,237021
1007458,40986,2194,11949,71360,126489
1007459,14904,41444,13174,65562,135084
1007460,19339,46543,6211,57484,129577
1007461,56873,90781,15531,30840,194025
1007462,65387,30180,621,93155,189343
1007463,4036,69171,49260,84142,206609
1007464,39293,23389,8486,41481,112649
1007465,99333,62950,73808,66197,302288
1007466,68628,37928,21475,64144,192175
1007467,87354,15464,57525,79595,239938
1007468,33486,60551,17662,95459,207158
1007469,76897,87612,15748,83394,263651
1007470,3141,4246,20743,34631,62761
1007471,66212,55000,59759,72631,253602
1007472,79639,24832,95770,50290,250531
1007473,96816,43870,93573,95598,329857
1007474,7510,8978,19094,551,36133
1007475,89878,48457,49470,76106,263911
1007476,97164,60027,12603,32449,202243
1007477,96745,58871,45577,74173,275366
1007478,95373,59931,66333,28763,250400
1007479,79412,34953,13708,88841,216914
1007480,74524,75229,88517,31785,270055
1007481,18539,71448,60240,80541,230768
1007482,12980,84623,33975,3923,135501
1007483,66779,5471,33462,73050,178762
1007484,46113,9755,15989,69624,141481
1007485,22190,71593,45079,60569,199431
1007486,57132,55224,93098,59569,265023
1007487,82299,21901,50794,60884,215878
1007488,63917,2590,48885,22982,138374
1007489,80970,39100,62039,27054,209163
1007490,11188,36556,8152,77020,132916
1007491,58787,88281,52716,23950,223734
1007492,29895,89264,51954,84811,255924
1007493,94486,91285,13614,98223,297608
1007494,93356,39120,35933,66682,235091
1007495,39498,25667,24558,59567,149290
1007496,78074,23732,94880,45382,242068
1007497,14541,52068,12217,73552,152378
1007498,51467,70482,1070,97920,220939
1007499,34571,94851,49351,20840,199613
1007500,5341,26546,63413,38990,134290
1007501,45649,10989,88941,83854,229433
1007502,8411,37740,15040,89052,150243
1007503,55106,41172,41301,72299,209878
1007504,65,76962,3118,93258,173403
1007505,30823,29358,86571,51427,198179
1007506,81893,71752,63225,80420,297290
1007507,69751,37534,26909,42502,176696
1007508,27927,47349,1054,37653,113983
1007509,53771,44961,94573,64250,257555
1007510,45918,5000,53108,53027,157053
1007511,47231,57165,63450,20071,187917
1007512,11727,23817,8763,36927,81234
1007513,87784,74702,14793,23291,200570
1007514,61830,96133,31401,59089,248453
1007515,87785,4518,5087,98876,196266
1007516,9429,32994,36422,80586,159431
1007517,57489,63139,54466,3188,178282
1007518,87887,5524,78095,75144,246650
1007519,72904,20744,18952,63919,176519
1007520,43628,51917,57751,71527,224823
1007521,89825,75496,48189,92089,305599
1007522,30595,40201,31249,36665,138710
1007523,82526,8206,31510,9610,131852
1007524,23387,40274,35026,57628,156315
1007525,21011,48788,10565,63549,143913
1007526,66727,70732,87843,41355,266657
1007527,97517,5338,14904,64384,182143
1007528,20908,89132,55927,38194,204161
1007529,53769,5409,59250,56073,174501
1007530,99219,45258,76552,73061,294090
1007531,32601,14862,62300,16317,126080
1007532,36737,4287,30867,93072,164963
1007533,66856,67725,39001,20303,193885
1007534,11138,52614,4570,63472,131794
1007535,12648,26352,8482,21774,69256
1007536,52442,31236,69105,49169,201952
1007537,22128,3351,22228,17385,65092
1007538,13704,27328,40417,19056,100505
1007539,89698,65026,26503,81305,262532
1007540,38873,15960,55300,98910,209043
1007541,23990,32106,58960,44095,159151
1007542,91026,64208,13747,48396,217377
1007543,3206,8812,44370,75356,131744
1007544,14153,17660,12867,15290,59970
1007545,93091,47982,73647,85517,300237
1007546,2477,70326,54391,85171,212365
1007547,71395,45228,76552,90111,283286
1007548,94355,31373,56758,70692,253178
1007549,64943,52961,15070,86122,219096
1007550,14829,82654,75470,72859,245812
1007551,57973,3010,16260,43927,121170
1007552,31723,43719,20933,97486,193861
1007553,34161,40464,75036,43555,193216
1007554,91589,19712,40482,28402,180185
1007555,17698,81664,1371,11968,112701
1007556,18153,47128,76920,26594,168795
1007557,88672,71227,5904,97447,263250
1007558,28446,32662,82854,33576,177538
1007559,9294,13559,36861,35127,94841
1007560,73006,54442,29651,35126,192225
1007561,17614,40499,45508,10001,113622
1007562,64128,84118,48564,41150,237960
1007563,77703,53809,41784,19400,192696
1007564,53607,8351,28000,41610,131568
1007565,73701,92658,63616,87379,317354
1007566,42437,78815,14212,6347,141811
1007567,7317,95278,35324,91811,229730
1007568,76927,99966,82240,2520,261653
1007569,51872,62976,76660,67516,259024
1007570,50982,654,21665,33959,107260
1007571,67950,73075,51820,22670,215515
1007572,6252,6285,52160,5201,69898
1007573,71494,19292,63052,14478,168316
1007574,46242,74426,57852,89490,268010
1007575,39312,72778,23474,84463,220027
1007576,10054,7320,65540,41922,124836
1007577,8776,63830,89142,51509,213257
1007578,97358,45977,82179,13094,238608
1007579,25222,14682,16947,85924,142775
1007580,52048,87089,228,32544,171909
1007581,56764,32286,33557,83064,205671
1007582,84687,78153,86557,7127,256524
1007583,26993,55438,23774,49093,155298
1007584,10075,95623,16368,81554,203620
1007585,96802,34734,17899,46507,195942
1007586,12682,31607,11333,54742,110364
1007587,31986,58485,15123,70053,175647
1007588,36637,26514,31900,12868,107919
1007589,7881,645,24235,38993,71754
1007590,30268,77584,61943,33540,203335
1007591,65283,3906,33516,87597,190302
1007592,92268,50883,45932,96357,285440
1007593,83913,20812,97365,77041,279131
1007594,60546,7062,51196,65435,184239
1007595,78470,51652,11999,89009,231130
1007596,35365,70651,52111,25777,183904
1007597,61154,39806,81821,20600,203381
1007598,2814,67582,73698,56759,200853
1007599,33215,35256,34393,21842,124706
1007600,96279,38921,49739,16497,201436
1007601,17951,27136,58415,90046,193548
1007602,6983,20906,38038,78719,144646
1007603,36449,69663,50992,89565,246669
1007604,28744,21338,49688,83775,183545
1007605,44652,56240,50620,63035,214547
1007606,56820,22359,69601,26989,175769
1007607,50322,87398,86691,48352,272763
1007608,14854,72607,50313,90201,227975
1007609,72323,30021,49237,4871,156452
1007610,95395,25955,82769,17175,221294
1007611,25387,6688,11842,11495,55412
1007612,35978,70003,3053,33954,142988
1007613,34276,29583,89912,61299,215070
1007614,54675,38265,42585,88588,224113
1007615,9814,71543,31847,71806,185010
1007616,9075,78363,25353,36519,149310
1007617,49514,15750,16593,34152,116009
1007618,69170,72770,65833,23831,231604
1007619,4393,56799,42356,66864,170412
1007620,19344,80035,34266,15492,149137
1007621,95790,12777,84579,82392,275538
1007622,33888,96931,62255,63657,256731
1007623,63697,85169,56024,92642,297532
1007624,75595,15752,27770,46566,165683
1007625,19367,17025,54220,92142,182754
1007626,80842,85102,60944,2321,229209
1007627,30244,56560,10169,86179,183152
1007628,81077,35123,64869,11995,193064
1007629,71860,4724,13296,49265,139145
1007630,30971,5906,84358,21258,142493
1007631,78296,73557,94469,64583,310905
1007632,10671,73391,93660,81471,259193
1007633,24508,24403,12406,29406,90723
1007634,65435,87358,2024,41138,195955
1007635,19341,5944,19702,22856,67843
1007636,33424,40205,85012,12858,171499
1007637,33759,15802,2500,76802,128863
1007638,83137,46748,47638,92389,269912
1007639,11499,76483,16593,25138,129713
1007640,11170,76856,55936,39252,183214
1007641,61561,47112,10329,59448,178450
1007642,1724,16279,83800,53721,155524
1007643,19790,60083,88585,90985,259443
1007644,74504,67238,60919,1218,203879
1007645,11330,54998,3116,89098,158542
1007646,41202,29150,50035,45683,166070
1007647,36985,70045,73093,88113,268236
1007648,89846,41386,95175,62685,289092
1007649,83057,72303,96112,92894,344366
1007650,82556,14145,34311,83300,214312
1007651,80848,24630,11477,54334,171289
1007652,89879,60109,89519,56496,296003
1007653,96549,48683,46805,39538,231575
1007654,32837,13197,7218,45906,99158
1007655,35888,31462,12806,44889,125045
1007656,23519,68965,18641,1459,112584
1007657,75109,2874,58600,17236,153819
1007658,52996,11885,49080,37493,151454
1007659,43381,2721,32241,55936,134279
1007660,78653,58461,72889,93722,303725
1007661,44842,79286,98822,16834,239784
1007662,36662,31059,57273,13140,138134
1007663,65409,34755,96709,82797,279670
1007664,37552,93176,41621,67244,239593
1007665,20027,32328,7546,75024,134925
1007666,84858,1681,54440,42122,183101
1007667,21997,71397,42051,57387,192832
1007668,28709,56398,35077,38460,158644
1007669,41442,34957,49091,59004,184494
1007670,1607,33194,63581,15195,113577
1007671,52030,65301,55002,24605,196938
1007672,46050,82873,76927,41028,246878
1007673,29671,55258,68512,12800,166241
1007674,58127,88491,18871,65383,230872
1007675,11284,64361,42002,97564,215211
1007676,68115,25749,52696,94252,240812
1007677,75940,95968,51460,15586,238954
1007678,32371,72050,89182,40938,234541
1007679,29081,44954,54109,19910,148054
1007680,57781,77693,84505,90107,310086
1007681,91283,86247,24240,17715,219485
1007682,22800,73223,25511,59054,180588
1007683,28662,24847,15113,16607,85229
1007684,33527,94085,86557,63301,277470
1007685,58010,49555,57706,34379,199650
1007686,18759,93461,25075,31906,169201
1007687,31961,16691,11083,99794,159529
1007688,22051,14349,32018,75104,143522
1007689,19507,26370,50769,94112,190758
1007690,32293,34308,50803,12973,130377
1007691,22047,88984,71580,43872,226483
1007692,64299,22765,44132,35396,166592
1007693,35916,92503,81234,8648,218301
1007694,82126,11319,48837,93867,236149
1007695,26821,90600,31236,19251,167908
1007696,75850,37014,83235,85004,281103
1007697,12831,33581,37018,21419,104849
1007698,65731,45779,65862,39252,216624
1007699,19886,10590,80682,10366,121524
1007700,55472,47466,45370,72263,220571
1007701,50971,87156,63209,62950,264286
1007702,71803,21826,45710,37791,177130
1007703,87216,92712,75879,88635,344442
1007704,63036,5509,24579,32995,126119
1007705,76136,44797,72366,42313,235612
1007706,74601,44316,75634,84858,279409
1007707,22587,13380,75536,98605,210108
1007708,98519,93740,56853,87794,336906
1007709,15298,32591,45560,22705,116154
1007710,84531,70846,8436,78431,242244
1007711,16049,31801,26701,64202,138753
1007712,90751,31673,85736,14592,222752
1007713,92198,58141,26371,87860,264570
1007714,71538,16892,9334,55080,152844
1007715,52190,56838,77539,8122,194689
1007716,9023,53943,28681,96523,188170
1007717,84477,72652,54997,98133,310259
1007718,79549,3530,91219,1212,175510
1007719,25384,51925,48409,71109,196827
1007720,19542,100000,72248,2036,193826
1007721,87651,86767,61378,51325,287121
1007722,219,90027,88834,11644,190724
1007723,68601,65467,27095,65713,226876
1007724,26673,48762,63410,69085,207930
1007725,34635,24973,73885,20586,154079
1007726,46702,47294,12667,46059,152722
1007727,41840,41200,60044,21710,164794
1007728,45928,34705,55730,75786,212149
1007729,38532,33789,11319,30192,113832
1007730,81395,27227,58327,3892,170841
1007731,20143,88940,14036,41669,164788
1007732,6906,99730,89209,22815,218660
1007733,9211,90440,19538,47394,166583
1007734,90552,62936,42547,82300,278335
1007735,28513,68722,16750,33969,147954
1007736,34417,16583,83148,34105,168253
1007737,47238,95296,73498,41580,257612
1007738,24021,18670,83433,72135,198259
1007739,65527,11054,8037,8178,92796
1007740,89373,19839,90756,73539,273507
1007741,10803,35836,71844,367,118850
1007742,14066,58248,92332,7929,172575
1007743,7383,86310,91934,90872,276499
1007744,89208,97244,27267,68226,281945
1007745,56412,45745,39887,46710,188754
1007746,90905,91623,1752,27673,211953
1007747,54555,57446,59210,75157,246368
1007748,97403,55132,20835,10237,183607
1007749,59998,63809,38789,70625,233221
1007750,6867,28609,73345,22331,131152
1007751,13148,59984,49284,77217,199633
1007752,58758,76421,19992,93645,248816
1007753,52536,4142,98237,98491,253406
1007754,17866,97962,12793,26678,155299
1007755,67155,23076,27458,51673,169362
1007756,56227,25688,59133,96813,237861
1007757,6494,42114,48532,52276,149416
1007758,97543,49556,58490,51924,257513
1007759,85490,62757,83626,66624,298497
1007760,70613,19434,56478,5846,152371
1007761,11331,25334,21535,21738,79938
1007762,59467,95067,1878,23871,180283
1007763,44807,43631,2683,64015,155136
1007764,86419,84974,41720,57084,270197
1007765,77591,48998,61263,90769,278621
1007766,92038,76162,54645,28501,251346
1007767,76167,76697,99109,12685,264658
1007768,16665,50831,65413,74793,207702
1007769,45285,65728,97188,31110,239311
1007770,67789,84170,47781,57562,257302
1007771,23278,17550,8262,46898,95988
1007772,63436,8054,10322,69905,151717
1007773,77528,6976,32022,56454,172980
1007774,5751,12144,12277,98735,128907
1007775,24803,84804,64173,62382,236162
1007776,81103,1460,62533,39900,184996
1007777,42965,4157,83544,83488,214154
1007778,28652,95615,77546,66826,268639
1007779,53359,93129,14953,32979,194420
1007780,90098,38889,34082,91675,254744
1007781,88403,67803,294,9681,166181
1007782,22537,73421,9672,95788,201418
1007783,37983,63500,69462,25617,196562
1007784,89897,54185,82865,30017,256964
1007785,50308,39022,55959,23799,169088
1007786,12985,89386,65570,40385,208326
1007787,50346,61183,59920,21697,193146
1007788,82679,21037,59343,36542,199601
1007789,23936,75158,74055,31874,205023
1007790,38248,27027,94780,96357,256412
1007791,96590,84742,81534,76008,338874
1007792,84731,50703,34678,56432,226544
1007793,60816,68697,43074,82389,254976
1007794,95742,90280,84117,99482,369621
1007795,42153,59353,56656,95310,253472
1007796,26059,65889,84360,50670,226978
1007797,75162,27958,53716,47577,204413
1007798,28010,51506,7842,67360,154718
1007799,71469,68477,14989,99573,254508
1007800,51327,3628,68038,92965,215958
1007801,17687,8575,89531,80279,196072
1007802,18983,47552,75818,1116,143469
1007803,55269,85927,18864,56148,216208
1007804,60041,63569,15820,87576,227006
1007805,36096,72959,42680,97587,249322
1007806,85818,86769,86925,26343,285855
1007807,93156,35855,11188,59480,199679
1007808,88164,91867,13846,37625,231502
1007809,45054,14346,29959,88694,178053
1007810,26034,72021,5649,18258,121962
1007811,50690,66841,8628,74025,200184
1007812,80800,55320,19170,19444,174734
1007813,49217,73577,42660,22864,188318
1007814,18370,4483,43624,5522,71999
1007815,86237,70621,78847,86779,322484
1007816,64839,4558,59773,12578,141748
1007817,54645,39708,48102,81243,223698
1007818,72049,38181,54629,74704,239563
1007819,81884,68276,71685,64694,286539
1007820,41259,61593,82827,5174,190853
1007821,45350,10189,6912,22515,84966
1007822,40914,34380,15244,30117,120655
1007823,43199,79672,19586,72538,214995
1007824,77221,52551,59753,29314,218839
1007825,86916,20962,5523,36450,149851
1007826,68420,83954,41352,51977,245703
1007827,50887,18240,92990,50682,212799
1007828,964,70688,21748,1456,94856
1007829,77339,89438,84292,60516,311585
1007830,48503,95004,3990,70728,218225
1007831,3307,89461,59812,88734,241314
1007832,4905,6719,31150,56458,99232
1007833,96916,33140,4268,14754,149078
1007834,13892,37879,34295,75427,161493
1007835,62174,70367,29875,34100,196516
1007836,47112,30274,289,53942,131617
1007837,36724,35143,98774,31623,202264
1007838,41946,24818,91291,36836,194891
1007839,16222,93223,47401,99106,255952
1007840,75742,25703,33064,78114,212623
1007841,1349,99182,92641,18893,212065
1007842,18181,14707,89034,54264,176186
1007843,40341,85993,81629,87880,295843
1007844,18946,64730,927,62652,147255
1007845,7451,40512,13980,76009,137952
1007846,12670,97089,4076,22129,135964
1007847,28717,82705,45101,24126,180649
1007848,18566,60328,46677,24511,150082
1007849,38328,47753,53545,53155,192781
1007850,70181,62253,82532,72371,287337
1007851,33153,14691,94840,75456,218140
1007852,22184,64970,62447,75928,225529
1007853,33460,58755,58711,76865,227791
1007854,83067,20098,14247,52703,170115
1007855,63989,94350,16617,51954,226910
1007856,22821,68241,77559,32765,201386
1007857,61421,79416,43199,1405,185441
1007858,66515,30468,36696,5225,138904
1007859,31328,10677,42999,86741,171745
1007860,26028,51193,26056,26186,129463
1007861,14345,80454,4784,91635,191218
1007862,50193,12904,59825,75051,197973
1007863,90295,7213,15307,26489,139304
1007864,78992,75043,31758,77411,263204
1007865,35997,526,91406,59292,187221
1007866,90743,71045,79393,43888,285069
1007867,47721,40769,45709,62313,196512
1007868,16521,70111,79230,68797,234659
1007869,36957,13245,16016,9720,75938
1007870,87633,28471,34356,64911,215371
1007871,2835,17320,16119,99815,136089
1007872,95007,71480,26661,61885,255033
1007873,56076,84630,83924,31480,256110
1007874,36240,29523,9040,32547,107350
1007875,5938,70891,44481,49719,171029
1007876,31391,46876,67379,24139,169785
1007877,79331,46151,31643,29879,187004
1007878,85258,50860,25494,87262,248874
1007879,76119,28532,97874,41641,244166
1007880,69648,54842,400,50321,175211
1007881,48856,97361,11338,95310,252865
1007882,29567,83034,70661,25516,208778
1007883,64729,44162,77299,97296,283486
1007884,32305,62003,41306,79853,215467
1007885,8862,41053,83233,46173,179321
1007886,99242,78826,78543,42028,298639
1007887,25772,6207,89613,29311,150903
1007888,29294,15139,41255,46512,132200
1007889,58868,52905,68648,81157,261578
1007890,43810,10672,99885,42452,196819
1007891,11664,51625,81202,62228,206719
1007892,87940,59256,15437,1674,164307
1007893,21023,36016,5416,38304,100759
1007894,12885,39761,82775,65981,201402
1007895,68070,63989,51123,12082,195264
1007896,59452,42111,6590,82160,190313
1007897,26807,43186,34163,96388,200544
1007898,23408,34681,90125,71361,219575
1007899,66584,81057,58217,35770,241628
1007900,44648,35046,96253,62445,238392
1007901,46148,32621,29965,3083,111817
1007902,73445,88773,25618,7166,195002
1007903,19150,91684,33926,20109,164869
1007904,33979,61409,72796,69657,237841
1007905,44736,32033,1896,73023,151688
1007906,2453,53096,10701,72835,139085
1007907,63733,9705,75814,92794,242046
1007908,14436,291,20526,11646,46899
1007909,23145,52669,94348,32084,202246
1007910,31577,47194,16701,70656,166128
1007911,31509,36642,91918,25644,185713
1007912,63410,74893,59437,31542,229282
1007913,27822,75960,58419,41966,204167
1007914,91828,87065,52915,7349,239157
1007915,56274,3328,9879,64088,133569
1007916,26250,67714,78820,73604,246388
1007917,9102,78942,65160,50392,203596
1007918,57834,35747,62807,49229,205617
1007919,91433,75552,10429,46346,223760
1007920,72250,42947,38156,44066,197419
1007921,58100,97879,26464,73930,256373
1007922,62345,19860,61627,85934,229766
1007923,20748,11808,58798,89585,180939
1007924,77413,57660,75854,8330,219257
1007925,21229,56513,74354,26885,178981
1007926,53414,90196,4053,19702,167365
1007927,19378,53024,23224,39785,135411
1007928,43341,13924,47749,97076,202090
1007929,41996,16331,92770,24760,175857
1007930,24596,80360,72951,41198,219105
1007931,23119,18062,988,66648,108817
1007932,53721,24553,52288,3800,134362
1007933,65574,63130,69846,13114,211664
1007934,17039,60519,13059,2063,92680
1007935,34232,97442,30868,8017,170559
1007936,47251,84787,80451,81272,293761
1007937,82377,57272,93451,79013,312113
1007938,34923,82986,36532,86071,240512
1007939,84113,84795,31326,61127,261361
1007940,83411,69012,46386,14451,213260
1007941,32830,31210,80389,40963,185392
1007942,83343,21659,61031,6564,172597
1007943,22180,62648,73588,58955,217371
1007944,19524,89344,84328,5764,198960
1007945,17864,92255,92487,67133,269739
1007946,54410,97149,25290,38091,214940
1007947,51078,71629,19425,49367,191499
1007948,55120,43691,99489,93326,291626
1007949,14343,28026,6623,14356,63348
1007950,10398,11988,41100,7977,71463
1007951,40435,23469,15378,79420,158702
1007952,49200,18655,62104,16772,146731
1007953,80870,408,74253,26180,181711
1007954,25986,3619,1696,33410,64711
1007955,22037,60548,73562,83868,240015
1007956,61487,72862,53293,69724,257366
1007957,69144,5559,44537,48478,167718
1007958,88222,70658,14867,89370,263117
1007959,43676,31462,2655,51251,129044
1007960,98753,40877,63834,23149,226613
1007961,34791,52719,25159,3420,116089
1007962,24404,23238,31769,78261,157672
1007963,28797,94491,34170,34614,192072
1007964,5461,20242,51440,21684,98827
1007965,19659,72530,58006,21194,171389
1007966,44636,80466,61667,18393,205162
1007967,14853,80055,83649,38751,217308
1007968,67422,30319,36814,68211,202766
1007969,84948,83502,52448,3313,224211
1007970,7326,23909,86470,98060,215765
1007971,64778,64163,58322,60026,247289
1007972,65564,9794,5592,96748,177698
1007973,76484,84713,52614,36878,250689
1007974,30540,56873,25108,33980,146501
1007975,24514,64096,41152,6132,135894
1007976,1687,30490,90219,40592,162988
1007977,61150,80496,57685,26455,225786
1007978,2857,30918,52573,91430,177778
1007979,40429,72178,15209,13465,141281
1007980,71617,22928,55214,44621,194380
1007981,27839,87017,90126,42561,247543
1007982,72990,21668,90664,95181,280503
1007983,50535,82983,90659,21734,245911
1007984,84591,63961,14726,59509,222787
1007985,36258,75113,43474,51552,206397
1007986,84452,45758,2456,39625,172291
1007987,74261,26526,56009,64448,221244
1007988,63842,11923,16989,52243,144997
1007989,9683,66694,78684,92115,247176
1007990,99021,23871,93089,36401,252382
1007991,55342,2878,95593,27220,181033
1007992,72881,15241,64794,7476,160392
1007993,68423,94280,16551,63022,242276
1007994,68124,34426,58347,73578,234475
1007995,55943,1012,64246,3376,124577
1007996,62061,23184,41773,1600,128618
1007997,65458,16081,33287,29661,144487
1007998,2235,41888,8905,27086,80114
1007999,27609,26942,68888,22999,146438
1008000,9915,57300,58493,94037,219745
1008001,52750,22177,87757,51865,214549
1008002,80751,51587,94839,91747,318924
1008003,48819,65789,99943,54407,268958
1008004,36840,39127,81657,77808,235432
1008005,26026,59922,6320,59476,151744
1008006,36698,47979,20112,63789,168578
1008007,8155,10609,87694,13967,120425
1008008,45748,12447,39178,15123,112496
1008009,7556,81854,51730,21152,162292
1008010,69868,19606,73126,3101,165701
1008011,27474,52101,30953,44675,155203
1008012,51011,34302,33480,46127,164920
1008013,49247,99260,92974,11296,252777
1008014,57547,7387,54052,71999,190985
1008015,48279,1041,65115,52671,167106
1008016,42410,99374,1625,40171,183580
1008017,6846,34376,35437,30121,106780
1008018,71169,14197,82280,53613,221259
1008019,86767,99900,87595,20275,294537
1008020,8925,82578,73893,70707,236103
1008021,88482,35498,81074,72431,277485
1008022,34192,13582,79852,51559,179185
1008023,96458,44479,46018,81911,268866
1008024,6848,19218,45816,43363,115245
1008025,90947,92909,91898,44364,320118
1008026,15713,15878,5102,83410,120103
1008027,7522,64873,44918,3360,120673
1008028,54156,54827,99704,20817,229504
1008029,84818,15313,24818,64102,189051
1008030,13241,8726,35923,19646,77536
1008031,79891,39353,65596,4779,189619
1008032,49345,37533,82578,25675,195131
1008033,89070,53673,51076,90473,284292
1008034,48273,78796,85238,74994,287301
1008035,43685,68523,44051,61198,217457
1008036,2140,65444,7885,44783,120252
1008037,18430,7154,36050,55801,117435
1008038,81133,6468,76685,25306,189592
1008039,8946,12828,9706,56306,87786
1008040,91082,34222,89555,57531,272390
1008041,88961,15799,76479,84862,266101
1008042,92186,42809,59073,82701,276769
1008043,56894,19440,18110,71968,166412
1008044,94436,28921,41694,84080,249131
1008045,53450,63995,16396,61899,195740
1008046,7731,46813,39247,16651,110442
1008047,15230,91464,52679,20847,180220
1008048,87565,25488,61939,35635,210627
1008049,20283,95565,70282,46466,232596
1008050,85931,7402,77271,13247,183851
1008051,4980,17360,7939,20437,50716
1008052,25077,60855,22628,54275,162835
1008053,27667,31970,46727,76518,182882
1008054,7259,98389,97094,75382,278124
1008055,46900,68321,18757,93112,227090
1008056,84759,35207,64151,56793,240910
1008057,45526,65444,54382,71800,237152
1008058,56428,39901,96731,48221,241281
1008059,24577,41664,11483,37358,115082
1008060,8611,86955,60822,71329,227717
1008061,2573,31575,5,99722,133875
1008062,1436,89218,6630,88980,186264
1008063,73414,20714,40847,16067,151042
1008064,94160,19214,95565,61015,269954
1008065,7672,11729,58885,71455,149741
1008066,47727,10908,34135,30,92800
1008067,50387,17367,62388,54569,184711
1008068,57396,66586,41289,29441,194712
1008069,26802,92649,13839,50191,183481
1008070,65524,12499,82038,2836,162897
1008071,17119,5644,25303,46673,94739
1008072,48371,13765,81731,34220,178087
1008073,29678,98704,96243,54433,279058
1008074,79895,36599,3375,14263,134132
1008075,32793,66846,45391,88555,233585
1008076,61309,65627,99138,51028,277102
1008077,74905,45649,42132,26302,188988
1008078,87872,70770,68101,78218,304961
1008079,64150,78482,7099,4943,154674
1008080,59587,46190,80350,21910,208037
1008081,38829,73870,89496,48625,250820
1008082,44238,6834,27620,97760,176452
1008083,14187,42550,76537,46824,180098
1008084,47742,30252,39439,85650,203083
1008085,70146,97940,14072,28221,210379
1008086,28751,93547,33789,84740,240827
1008087,9743,25631,61391,856,97621
1008088,67184,54330,74298,50104,245916
1008089,53905,45028,18041,16406,133380
1008090,35409,4330,80351,53339,173429
1008091,50311,69917,49851,44528,214607
1008092,63228,73514,27692,31973,196407
1008093,15760,14175,24672,38447,93054
1008094,72680,36764,70271,26350,206065
1008095,32697,32163,6329,24630,95819
1008096,83730,85319,32949,13735,215733
1008097,56597,4867,76510,16213,154187
1008098,2934,90995,32451,98036,224416
1008099,98634,64315,65769,50177,278895
1008100,66646,32651,20735,37237,157269
1008101,68452,65132,89764,93763,317111
1008102,97442,87500,43552,54421,282915
1008103,650,54532,27150,47088,129420
1008104,11582,42790,54197,81544,190113
1008105,31924,34963,64857,80897,212641
1008106,82473,60742,90893,73312,307420
1008107,54078,28016,86594,71582,240270
1008108,51119,74279,24508,86500,236406
1008109,70360,18426,18725,37022,144533
1008110,67733,88871,64614,99853,321071
1008111,24080,81552,10897,44745,161274
1008112,30324,52282,27714,17309,127629
1008113,21164,12737,48848,29277,112026
1008114,8643,76044,49227,45522,179436
1008115,40034,93616,34974,94165,262789
1008116,32753,84278,86550,90610,294191
1008117,41796,69911,86451,40928,239086
1008118,19911,82965,37634,69500,210010
1008119,63621,77719,1892,66916,210148
1008120,5242,93391,59737,31047,189417
1008121,91944,8323,77840,18898,197005
1008122,98190,36981,52487,67107,254765
1008123,31655,18755,76999,67455,194864
1008124,5922,75742,29737,8679,120080
1008125,4367,50867,94396,90359,239989
1008126,61406,22483,35989,79665,199543
1008127,42007,88088,69078,43461,242634
1008128,71085,34045,57591,97965,260686
1008129,21723,92468,11289,63429,188909
1008130,13290,59165,7356,98237,178048
1008131,99606,77535,55183,8048,240372
1008132,94281,74351,58468,72960,300060
1008133,61818,13195,94657,19468,189138
1008134,32692,38026,40278,92158,203154
1008135,31854,179,51290,88859,172182
1008136,67425,29662,88101,15358,200546
1008137,36707,19541,61284,45317,162849
1008138,8181,67993,86478,25389,188041
1008139,97924,23182,6964,20128,148198
1008140,58581,69697,91931,61714,281923
1008141,59130,91195,84904,29796,265025
1008142,16301,30345,34172,51938,132756
1008143,84052,36420,28548,17596,166616
1008144,77028,85409,79908,66093,308438
1008145,65498,43984,58509,87402,255393
1008146,81830,41667,36352,79549,239398
1008147,86821,86306,68448,80437,322012
1008148,69032,57367,73702,63560,263661
1008149,69608,50451,2040,81189,203288
1008150,27548,21570,84210,47263,180591
1008151,61810,81591,45915,46634,235950
1008152,32475,33874,72419,8323,147091
1008153,92466,36191,66055,61860,256572
1008154,33718,48349,31077,39429,152573
1008155,53675,82832,45172,73399,255078
1008156,35150,19522,96619,68981,220272
1008157,59111,96654,56272,54436,266473
1008158,62049,91285,95168,87528,336030
1008159,69537,86720,81446,69495,307198
1008160,17406,13828,64809,81476,177519
1008161,49715,31027,8025,18850,107617
1008162,58814,80005,39992,17812,196623
1008163,93879,1573,28591,70254,194297
1008164,27670,73242,61401,31671,193984
1008165,1285,27096,54094,37334,119809
1008166,45321,60180,95277,99005,299783
1008167,81986,85178,95473,60065,322702
1008168,31841,92326,11262,45711,181140
1008169,82657,26701,38709,36859,184926
1008170,70127,66327,52999,88911,278364
1008171,94847,33087,57393,88459,273786
1008172,31739,51713,69311,95714,248477
1008173,46549,33894,3797,81170,165410
1008174,87463,80173,46361,63220,277217
1008175,94683,25020,46757,84735,251195
1008176,83986,51663,75861,98048,309558
1008177,2519,74858,76888,7549,161814
1008178,3087,17790,57653,41513,120043
1008179,84898,71366,41241,41641,239146
1008180,37227,6850,7985,76661,128723
1008181,88977,80118,69077,31126,269298
1008182,34520,49078,3354,62455,149407
1008183,56698,1834,44343,94953,197828
1008184,67438,70912,4203,89222,231775
1008185,75236,34126,65400,84501,259263
1008186,35685,99503,28025,16931,180144
1008187,67855,89319,79535,44544,281253
1008188,3892,92202,1244,39055,136393
1008189,1723,33665,16607,57196,109191
1008190,35244,43006,91457,72284,241991
1008191,30451,13085,49869,70015,163420
1008192,85474,28798,96468,78008,288748
1008193,31051,72506,25019,5291,133867
1008194,95499,57664,33726,5443,192332
1008195,39481,4335,8746,51212,103774
1008196,67557,2748,35475,38709,144489
1008197,28380,32782,20203,49927,131292
1008198,46623,3590,86540,54390,191143
1008199,72107,72008,7913,18745,170773
1008200,8960,55787,21262,91796,177805
1008201,47609,75181,42412,12218,177420
1008202,66521,97644,3849,19009,187023
1008203,13513,3556,17585,36945,71599
1008204,24998,55753,62042,62227,205020
1008205,67776,68564,47947,9140,193427
1008206,4393,56219,81547,3754,145913
1008207,9885,42630,24063,51741,128319
1008208,19552,67819,93999,45187,226557
1008209,45739,29594,76237,80683,232253
1008210,37734,97196,19116,21594,175640
1008211,43982,68315,59036,34456,205789
1008212,20198,90829,57485,37467,205979
1008213,37781,33727,64624,36992,173124
1008214,75800,95056,86998,1974,259828
1008215,35084,30827,27716,70026,163653
1008216,96165,49735,46674,3641,196215
1008217,6682,79386,83827,66740,236635
1008218,29043,88940,99357,95610,312950
1008219,14012,78372,33644,20647,146675
1008220,89251,52285,43384,16620,201540
1008221,86063,50926,91008,5937,233934
1008222,14402,4825,2494,29159,50880
1008223,55181,71423,80454,53810,260868
1008224,3869,73859,95744,86024,259496
1008225,28412,12903,84988,56147,182450
1008226,92223,96644,86494,74179,349540
1008227,98406,18745,39791,4012,160954
1008228,39037,95015,93145,37198,264395
1008229,92060,24169,39415,80355,235999
1008230,48895,58559,92265,96096,295815
1008231,19134,98202,53654,15088,186078
1008232,76404,70363,74150,72564,293481
1008233,23057,25410,24334,95571,168372
1008234,58192,64575,56087,58318,237172
1008235,35855,99095,58384,98442,291776
1008236,62779,5773,32533,46433,147518
1008237,45234,82335,17858,54573,200000
1008238,64474,49082,78788,10898,203242
1008239,20079,68489,47053,12888,148509
1008240,84604,60339,99809,74718,319470
1008241,96302,42189,35886,53892,228269
1008242,35154,45930,88200,3884,173168
1008243,2606,45690,21025,90894,160215
1008244,58759,71044,8932,5435,144170
1008245,47859,79106,26620,50412,203997
1008246,20780,20539,29490,81654,152463
1008247,67151,79529,37210,5783,189673
1008248,1170,32334,95193,1676,130373
1008249,8674,58459,16632,53255,137020
1008250,60633,4682,67606,91324,224245
1008251,10659,19054,23730,39895,93338
1008252,83790,15831,34995,52206,186822
1008253,1628,46904,6767,23853,79152
1008254,70700,96815,24870,15499,207884
1008255,71115,82787,33643,96463,284008
1008256,48600,19459,19195,58619,145873
1008257,44420,13971,43198,45677,147266
1008258,97330,74599,29728,60771,262428
1008259,59960,68965,96406,64133,289464
1008260,34889,68732,89725,37457,230803
1008261,42243,3271,94903,70152,210569
1008262,6979,39199,53016,31369,130563
1008263,94823,40105,70507,18436,223871
1008264,63824,15322,7324,35809,122279
1008265,70074,11143,38648,29983,149848
1008266,31208,43687,39488,77885,192268
1008267,77728,37729,94125,42369,251951
1008268,31473,15615,41478,26876,115442
1008269,14185,49359,48519,7537,119600
1008270,88984,93118,53694,64937,300733
1008271,73092,5922,4276,93066,176356
1008272,51341,18485,79122,58495,207443
1008273,29582,41274,49473,92096,212425
1008274,64237,47149,34214,69501,215101
1008275,25720,99241,20067,42986,188014
1008276,98258,24765,58877,71466,253366
1008277,43055,18123,67001,12720,140899
1008278,24628,70262,26026,43951,164867
1008279,51653,87800,91000,68511,298964
1008280,31079,81509,64952,46966,224506
1008281,67204,51160,17683,80307,216354
1008282,48988,95181,46139,46300,236608
1008283,38617,42463,26539,20429,128048
1008284,95018,80290,21463,44392,241163
1008285,8040,30820,2124,39198,80182
1008286,88535,59333,75858,92446,316172
1008287,2914,5475,30550,27589,66528
1008288,55108,68487,2443,62156,188194
1008289,56507,51446,93740,69063,270756
1008290,54408,85417,41376,8114,189315
1008291,42086,28209,15509,12748,98552
1008292,33225,84829,22879,78269,219202
1008293,990,75429,60989,58439,195847
1008294,79957,90166,46312,98907,315342
1008295,20069,39979,36200,46454,142702
1008296,17818,42440,90118,50931,201307
1008297,4727,84379,52027,53683,194816
1008298,32362,7482,83499,2061,125404
1008299,49997,13780,31806,52761,148344
1008300,98334,97192,67898,77992,341416
1008301,17309,17537,79072,46479,160397
1008302,1856,27991,77258,47682,154787
1008303,17785,25283,93976,69267,206311
1008304,21270,8279,39550,51506,120605
1008305,99224,35227,66651,81516,282618
1008306,78556,98453,40731,49140,266880
1008307,49001,49037,5904,95215,199157
1008308,47642,36680,85731,11046,181099
1008309,78419,29806,75240,43852,227317
1008310,99396,71628,30594,56200,257818
1008311,39883,74047,83200,67292,264422
1008312,898,890,10046,15122,26956
1008313,6256,38217,54091,19450,118014
1008314,22775,91356,51212,80222,245565
1008315,86280,70360,27706,3056,187402
1008316,62785,76443,79459,95955,314642
1008317,82966,77015,40989,71576,272546
1008318,83016,15978,70691,26744,196429
1008319,87124,30129,98267,27839,243359
1008320,76421,21669,72654,45579,216323
1008321,31866,36209,97018,89655,254748
1008322,60904,31219,27652,79384,199159
1008323,16035,24484,46919,99961,187399
1008324,78446,54186,43070,39482,215184
1008325,62549,34959,81413,88525,267446
1008326,51243,40462,53860,70075,215640
1008327,61730,71981,82766,14191,230668
1008328,36431,7400,46401,23403,113635
1008329,43298,1038,47624,71016,162976
1008330,99036,66854,49839,70884,286613
1008331,19382,20010,42795,42519,124706
1008332,57802,92709,10905,6236,167652
1008333,39649,89394,31549,82350,242942
1008334,54679,50776,5157,82952,193564
1008335,33607,24554,12713,40833,111707
1008336,68440,29508,65628,45689,209265
1008337,59283,34306,35013,53032,181634
1008338,87421,45598,52931,56696,242646
1008339,58786,70362,99468,15510,244126
1008340,5426,29759,49190,12768,97143
1008341,20393,45447,29251,84854,179945
1008342,26426,25877,29365,90914,172582
1008343,80849,24627,69589,44586,219651
1008344,17326,79976,65035,10012,172349
1008345,15022,48038,93864,42200,199124
1008346,20017,23949,88685,6492,139143
1008347,29535,42644,23008,82860,178047
1008348,70822,61168,15193,72731,219914
1008349,98840,2175,84560,54063,239638
1008350,91397,38244,72165,65924,267730
1008351,63041,66109,54882,73540,257572
1008352,59995,27366,53098,34818,175277
1008353,81797,56900,35169,27168,201034
1008354,19361,13694,96141,83385,212581
1008355,23316,86276,13467,10609,133668
1008356,54902,62323,63177,73857,254259
1008357,66237,49942,63361,72520,252060
1008358,9597,58412,60797,83957,212763
1008359,12811,36814,89448,37962,177035
1008360,94817,39778,45326,35369,215290
1008361,30919,11061,62424,58209,162613
1008362,66081,89057,26407,33098,214643
1008363,34424,1407,18707,67106,121644
1008364,2209,74817,68503,47193,192722
1008365,48729,99665,85927,43388,277709
1008366,22043,14092,57155,10020,103310
1008367,91987,76975,80104,56520,305586
1008368,15670,59607,16516,45787,137580
1008369,83172,83353,1231,31314,199070
1008370,25179,49555,92938,94135,261807
1008371,12735,81230,21905,11253,127123
1008372,27512,12510,39232,71645,150899
1008373,30996,97783,93039,62389,284207
1008374,46671,91857,50256,44426,233210
1008375,44069,75526,993,1469,122057
1008376,18717,66428,2393,38520,126058
1008377,93157,7845,87826,40596,229424
1008378,29137,69230,10953,62322,171642
1008379,84764,77124,20822,53896,236606
1008380,56003,61258,94315,81789,293365
1008381,80891,31480,91370,83896,287637
1008382,85290,27354,60969,86882,260495
1008383,20262,46721,92077,50436,209496
1008384,24316,77674,67045,59355,228390
1008385,76341,74266,7605,25894,184106
1008386,16614,45595,77959,31651,171819
1008387,14653,80041,61043,69534,225271
1008388,54668,99918,6527,24296,185409
1008389,46761,27678,93341,25417,193197
1008390,40194,97265,83719,74883,296061
1008391,32998,78464,75352,31405,218219
1008392,44479,91119,34030,22873,192501
1008393,38745,16659,16142,26294,97840
1008394,60500,48339,39535,19497,167871
1008395,38129,18073,49782,88842,194826
1008396,64220,11935,23686,84729,184570
1008397,86906,56683,89215,35175,267979
1008398,72975,64513,39144,81425,258057
1008399,10403,42120,26707,97594,176824
1008400,11121,36635,10893,79127,137776
1008401,20203,53033,40220,83629,197085
1008402,55800,37608,77440,19695,190543
1008403,48879,67809,12867,95491,225046
1008404,97752,52225,1327,76705,228009
1008405,16260,71591,9840,19847,117538
1008406,72301,88166,6033,98916,265416
1008407,14045,40504,50517,42690,147756
1008408,39875,44850,62382,85887,232994
1008409,44117,17981,51301,66812,180211
1008410,12794,69005,29200,29895,140894
1008411,57242,79127,51894,6133,194396
1008412,18997,90410,13793,73172,196372
1008413,74457,407,81780,61234,217878
1008414,80660,5862,64261,76166,226949
1008415,46520,27988,58157,81127,213792
1008416,11388,90827,78251,42263,222729
1008417,32433,16662,27860,22216,99171
1008418,75126,85972,69509,35297,265904
1008419,98898,30934,55470,86948,272250
1008420,11345,42564,69437,19230,142576
1008421,15733,1795,56993,4088,78609
1008422,57681,93430,87550,7585,246246
1008423,66368,73693,13219,23980,177260
1008424,80605,50285,40574,47429,218893
1008425,49632,80088,92948,85803,308471
1008426,20201,91601,38890,97929,248621
1008427,18285,30149,73033,85712,207179
1008428,97538,68608,95252,58094,319492
1008429,69239,9708,55119,96103,230169
1008430,74710,13358,89746,95509,273323
1008431,65677,56251,95278,6687,223893
1008432,44089,34446,79240,81114,238889
1008433,51890,16054,13926,40821,122691
1008434,43431,10806,85784,24728,164749
1008435,5285,53885,71382,29475,160027
1008436,35154,43953,78252,35941,193300
1008437,71133,86875,99891,13140,271039
1008438,69386,61616,50455,12539,193996
1008439,99107,5769,67871,83774,256521
1008440,79822,58534,48242,65560,252158
1008441,14779,61597,57952,84462,218790
1008442,44113,26299,13086,65975,149473
1008443,38320,21028,91299,40571,191218
1008444,80332,40320,71899,28170,220721
1008445,20620,74381,93826,71911,260738
1008446,75885,15226,36230,62560,189901
1008447,82875,25018,42403,84010,234306
1008448,94596,59202,13511,15242,182551
1008449,11703,78877,16920,1971,109471
1008450,44334,54272,13682,31395,143683
1008451,90029,99506,36400,59661,285596
1008452,44092,44705,49553,4686,143036
1008453,30759,20249,32817,47252,131077
1008454,12765,6581,91909,98995,210250
1008455,5240,71442,60924,75213,212819
1008456,76607,93376,38089,510,208582
1008457,67121,78194,60533,61767,267615
1008458,32889,8410,48313,10697,100309
1008459,9934,24087,28464,7841,70326
1008460,38876,8317,18739,22427,88359
1008461,10347,53403,74813,17289,155852
1008462,35555,32551,86464,70804,225374
1008463,61519,54208,89307,75282,280316
1008464,51164,48396,47882,21536,168978
1008465,48485,46810,43294,61748,200337
1008466,8902,1224,18941,95128,124195
1008467,14364,81548,22343,99134,217389
1008468,39994,30569,54897,31918,157378
1008469,75569,37758,6263,32787,152377
1008470,69494,72824,79682,45153,267153
1008471,91631,65232,86736,3602,247201
1008472,71012,85950,99405,22981,279348
1008473,91693,97308,85845,73317,348163
1008474,47144,91608,82190,67545,288487
1008475,28027,18648,51164,95536,193375
1008476,36749,94455,33878,32384,197466
1008477,8978,14152,97099,80254,200483
1008478,70986,591,4076,69793,145446
1008479,15841,47989,78292,7439,149561
1008480,26684,52261,44061,16039,139045
1008481,16047,66174,2509,62899,147629
1008482,72549,10198,60118,18509,161374
1008483,18291,34845,81202,20082,154420
1008484,161,85797,53177,98249,237384
1008485,34911,94050,4511,82920,216392
1008486,41263,85796,23653,62642,213354
1008487,35662,85050,72661,41647,235020
1008488,53733,25988,80475,64956,225152
1008489,54312,19340,66839,57594,198085
1008490,95548,32715,85010,53569,266842
1008491,96664,96728,4257,74424,272073
1008492,43199,53759,14581,89566,201105
1008493,87323,87687,48235,63257,286502
1008494,4755,75533,55686,59924,195898
1008495,31240,5334,60058,98313,194945
1008496,33136,50910,82563,41195,207804
1008497,83278,94874,33195,95291,306638
1008498,40233,65073,77656,66049,249011
1008499,2467,18648,29976,94081,145172
1008500,15149,99733,36223,63986,215091
1008501,95939,44791,10557,27564,178851
1008502,29675,18604,6184,22758,77221
1008503,32255,29311,41525,84050,187141
1008504,74284,48969,31163,87597,242013
1008505,83999,68832,74855,36841,264527
1008506,54572,67490,43872,76979,242913
1008507,1361,6002,21710,83551,112624
1008508,3817,13860,98502,95625,211804
1008509,40314,20743,97802,33152,192011
1008510,99489,20289,24741,32277,176796
1008511,190,45153,55135,784,101262
1008512,64536,20986,90535,60892,236949
1008513,940,67132,26813,51174,146059
1008514,53702,54187,93263,61231,262383
1008515,55582,70429,50491,57988,234490
1008516,57848,27782,15417,67609,168656
1008517,82570,90720,85751,10996,270037
1008518,76477,89998,56950,86756,310181
1008519,84273,52612,64107,39807,240799
1008520,6700,93391,97392,31331,228814
1008521,37890,70398,4197,73206,185691
1008522,2782,51604,54735,29627,138748
1008523,48416,36399,81200,32831,198846
1008524,46142,56601,16499,33793,153035
1008525,68024,11084,132,52577,131817
1008526,62976,36350,11308,84564,195198
1008527,35822,54463,35259,80686,206230
1008528,28474,5182,23273,83336,140265
1008529,89740,26202,4465,94500,214907
1008530,51336,17901,77250,39797,186284
1008531,2254,16336,70054,60374,149018
1008532,86070,44482,39539,71179,241270
1008533,72719,90642,13804,94333,271498
1008534,35536,56000,37055,35010,163601
1008535,16167,43838,55223,21579,136807
1008536,83680,76948,56861,5571,223060
1008537,16588,35601,99555,64272,216016
1008538,88837,56527,62435,45075,252874
1008539,8493,6617,92553,82927,190590
1008540,53946,58576,17470,58472,188464
1008541,98070,40058,61930,5757,205815
1008542,77050,9489,45755,65624,197918
1008543,48699,98981,94366,98825,340871
1008544,34741,33989,76718,27647,173095
1008545,61787,65405,48259,41968,217419
1008546,25701,52575,7485,65390,151151
1008547,65256,27307,4648,27328,124539
1008548,88644,91283,72774,52985,305686
1008549,87144,65560,79122,39760,271586
1008550,7929,13167,93087,1101,115284
1008551,22429,95076,15469,83438,216412
1008552,38109,17922,71786,14231,142048
1008553,21648,42122,2945,42928,109643
1008554,65132,51553,52009,57224,225918
1008555,72680,42936,28808,41639,186063
1008556,85613,88572,68811,70427,313423
1008557,4647,52694,98487,96654,252482
1008558,85145,92187,43422,54708,275462
1008559,2870,82069,40792,54786,180517
1008560,79117,7552,29309,57172,173150
1008561,59367,73589,73190,48866,255012
1008562,2644,80301,16657,97325,196927
1008563,7010,25652,6071,31674,70407
1008564,11925,50282,67868,70024,200099
1008565,4303,78790,33212,42397,158702
1008566,98489,35698,1343,39952,175482
1008567,56134,94029,18519,94349,263031
1008568,86778,39585,22326,62269,210958
1008569,91744,31052,53873,59017,235686
1008570,49120,99015,91827,16302,256264
1008571,20086,46240,23000,85244,174570
1008572,64679,71767,52420,27047,215913
1008573,26794,30107,46759,25652,129312
1008574,52724,76982,71820,42509,244035
1008575,59885,10476,16620,52596,139577
1008576,27836,79948,23749,8245,139778
1008577,53147,151,859,65755,119912
1008578,9222,59715,70848,14632,154417
1008579,73841,58927,54204,72719,259691
1008580,58374,68057,54796,83347,264574
1008581,5235,12233,66045,63412,146925
1008582,97047,30824,50082,94281,272234
1008583,28201,48745,26024,6217,109187
1008584,46037,90983,10641,86409,234070
1008585,10131,10481,85616,92760,198988
1008586,41661,62684,4804,28217,137366
1008587,88993,75435,40936,80446,285810
1008588,72261,10788,48413,99925,231387
1008589,83031,44715,27973,66774,222493
1008590,98110,77750,10615,36833,223308
1008591,93146,38766,90911,27379,250202
1008592,13149,96719,38056,56365,204289
1008593,54910,85774,97541,95785,334010
1008594,50844,29581,94118,22614,197157
1008595,53153,9742,88035,3785,154715
1008596,9377,82838,55927,19052,167194
1008597,55200,65623,18335,75284,214442
1008598,18348,3326,82990,21703,126367
1008599,8495,98077,63658,15903,186133
1008600,8140,16353,39317,87658,151468
1008601,9760,23996,93656,57747,185159
1008602,27755,32425,16719,94754,171653
1008603,81830,73245,53516,81837,290428
1008604,76035,33819,87658,40479,237991
1008605,74678,97904,10965,24069,207616
1008606,32874,88396,33133,8209,162612
1008607,23276,20753,90111,15900,150040
1008608,83142,66200,61709,9100,220151
1008609,56265,16198,27294,16143,115900
1008610,4763,14455,70073,91909,181200
1008611,53477,20819,74325,1576,150197
1008612,9850,12406,4825,11057,38138
1008613,26230,33342,93339,27339,180250
1008614,81895,11958,97999,80423,272275
1008615,21340,58449,69822,77607,227218
1008616,17929,89165,20323,65325,192742
1008617,39701,32824,71534,27195,171254
1008618,30110,81025,77517,84376,273028
1008619,11334,8398,13775,47446,80953
1008620,13775,89177,12183,83354,198489
1008621,81380,62372,86110,45151,275013
1008622,70453,14170,7785,48434,140842
1008623,94203,21746,71599,1363,188911
1008624,10634,48706,18800,99251,177391
1008625,12687,98352,39107,95359,245505
1008626,41907,57814,35463,4345,139529
1008627,87098,62143,657,41705,191603
1008628,81261,99043,70241,90704,341249
1008629,63911,8420,25524,36510,134365
1008630,90385,35305,13929,24868,164487
1008631,86871,94437,24985,89241,295534
1008632,50913,69674,75206,66432,262225
1008633,92761,91469,53992,66664,304886
1008634,36783,37728,68309,13571,156391
1008635,96294,7469,82022,93706,279491
1008636,12163,73846,38288,47573,171870
1008637,40540,24787,76279,54423,196029
1008638,24055,9435,31326,71019,135835
1008639,31985,5760,73840,34026,145611
1008640,91963,74658,39473,57563,263657
1008641,92324,58149,73203,43829,267505
1008642,7233,78023,90643,50150,226049
1008643,91880,31991,64701,7376,195948
1008644,12054,75455,57725,29974,175208
1008645,75009,43742,62594,235,181580
1008646,17307,78988,47556,6583,150434
1008647,57865,51814,39942,6511,156132
1008648,69673,49909,2565,28641,150788
1008649,37805,7646,86764,22449,154664
1008650,67028,5201,96869,26452,195550
1008651,11489,28369,67939,15670,123467
1008652,17744,60238,53392,3701,135075
1008653,50043,50377,31999,90672,223091
1008654,53373,74668,66705,980,195726
1008655,38816,5455,28824,96063,169158
1008656,63698,10319,74270,49332,197619
1008657,47927,41621,63473,83847,236868
1008658,53888,20358,30416,83629,188291
1008659,9929,77270,64216,66842,218257
1008660,90682,17600,36642,64584,209508
1008661,25302,50932,56668,73445,206347
1008662,53047,87652,70671,53755,265125
1008663,66506,31473,31304,35307,164590
1008664,14462,3618,10352,42637,71069
1008665,39069,67887,98563,17818,223337
1008666,84257,80269,52794,30081,247401
1008667,13267,38309,66064,62039,179679
1008668,3061,27983,81004,60280,172328
1008669,51461,22974,49291,28793,152519
1008670,44725,12493,22476,9188,88882
1008671,6758,11667,57472,53254,129151
1008672,24958,71487,66593,90907,253945
1008673,17894,59243,35721,58090,170948
1008674,41642,97846,56686,85297,281471
1008675,75789,21468,95384,26615,219256
1008676,78201,1395,62396,37854,179846
1008677,56926,79963,8461,27932,173282
1008678,83039,69393,97643,83757,333832
1008679,81210,66697,4110,89451,241468
1008680,16596,35035,78635,51675,181941
1008681,8093,59106,66382,98808,232389
1008682,85748,50563,6923,8152,151386
1008683,19580,42544,28572,62074,152770
1008684,88589,8117,12868,37158,146732
1008685,97916,82867,42892,38116,261791
1008686,38120,94832,21106,83431,237489
1008687,46511,631,79726,30585,157453
1008688,11511,50960,19551,92605,174627
1008689,35316,24315,35905,24575,120111
1008690,9144,59507,39468,93041,201160
1008691,9084,28793,52792,78382,169051
1008692,63594,93152,92852,39640,289238
1008693,34588,2160,97339,38625,172712
1008694,78732,8540,18930,42143,148345
1008695,53503,36273,85221,13369,188366
1008696,25154,66167,9822,23313,124456
1008697,44151,40198,81025,54236,219610
1008698,64729,20586,513,18643,104471
1008699,18340,82307,38719,1856,141222
1008700,35381,42411,30201,85978,193971
1008701,93260,24183,49262,46639,213344
1008702,91179,90552,13853,97772,293356
1008703,15822,40407,91468,84514,232211
1008704,44520,69035,81649,93342,288546
1008705,2420,72863,49719,94136,219138
1008706,27130,74692,45805,94822,242449
1008707,20905,44572,7042,71881,144400
1008708,65846,89954,46880,30271,232951
1008709,60728,93290,24679,39020,217717
1008710,48038,84659,83872,18433,235002
1008711,27808,17999,79495,22950,148252
1008712,20960,27100,75219,93967,217246
1008713,60703,27689,25301,57029,170722
1008714,20238,44964,96318,60576,222096
1008715,79080,46851,84003,35941,245875
1008716,78782,1425,7730,35061,122998
1008717,22005,74703,59367,78871,234946
1008718,76693,31463,89564,27157,224877
1008719,26327,64162,29527,93464,213480
1008720,45814,79535,48149,90013,263511
1008721,22392,98773,13621,17674,152460
1008722,82232,24791,88189,85707,280919
1008723,62495,22069,94679,1485,180728
1008724,75190,1412,31413,24370,132385
1008725,39912,70723,70551,45734,226920
1008726,50062,14068,54983,74907,194020
1008727,23644,46225,22367,57895,150131
1008728,81378,20755,92737,52747,247617
1008729,58191,32306,21504,88086,200087
1008730,59849,8753,85100,73599,227301
1008731,80462,43217,51127,54534,229340
1008732,1539,83169,19532,21866,126106
1008733,67157,54703,13137,16620,151617
1008734,67869,94026,62810,6643,231348
1008735,56667,18144,31634,28261,134706
1008736,35913,86415,46868,25568,194764
1008737,70896,65288,13074,6516,155774
1008738,43089,65015,46837,53612,208553
1008739,55372,23992,91897,78739,250000
1008740,5932,25565,86648,17782,135927
1008741,85473,92575,40061,37687,255796
1008742,66336,29943,55023,55529,206831
1008743,22537,21128,74341,67788,185794
1008744,81025,37902,31232,17421,167580
1008745,71082,31293,30909,9017,142301
1008746,28668,12050,1992,42846,85556
1008747,83518,52577,51231,75278,262604
1008748,1456,18479,71669,63292,154896
1008749,25956,2535,24251,3795,56537
1008750,23682,41169,20720,14756,100327
1008751,70893,66862,75819,5242,218816
1008752,21669,88925,58946,2814,172354
1008753,42642,18327,68172,86039,215180
1008754,60308,75268,61924,63572,261072
1008755,96904,48708,3419,55820,204851
1008756,18373,11438,34511,57199,121521
1008757,45494,88958,80697,61391,276540
1008758,84477,42723,73907,8423,209530
1008759,45193,55645,42431,39563,182832
1008760,99400,90591,59803,39208,289002
1008761,42793,73206,13300,22115,151414
1008762,11436,14515,96604,14451,137006
1008763,12329,50083,4232,94278,160922
1008764,2285,24615,27498,20850,75248
1008765,59072,26072,57426,95060,237630
1008766,33483,473,92114,78254,204324
1008767,85975,91450,83949,6085,267459
1008768,57584,58615,48791,89656,254646
1008769,8632,52862,33212,97886,192592
1008770,88163,10576,3,62796,161538
1008771,3661,67294,66391,69884,207230
1008772,34989,64242,43743,78304,221278
1008773,41529,3815,92002,50359,187705
1008774,54920,37608,79628,37660,209816
1008775,20873,75992,52016,94852,243733
1008776,42632,49544,91611,71854,255641
1008777,26408,48422,99490,66431,240751
1008778,9938,52362,6977,66965,136242
1008779,74041,64699,42200,53606,234546
1008780,37737,6192,50959,19508,114396
1008781,46080,9822,31820,16834,104556
1008782,85897,53446,60721,12050,212114
1008783,55690,16695,18895,75488,166768
1008784,47249,22821,8007,64853,142930
1008785,89011,12676,95086,69821,266594
1008786,76899,95029,29837,957,202722
1008787,97970,45324,60184,90340,293818
1008788,67976,81997,54290,347,204610
1008789,5365,50695,31907,40666,128633
1008790,63501,5150,1361,89663,159675
1008791,45205,76190,97119,14685,233199
1008792,42771,85471,248,99208,227698
1008793,30175,94770,91522,86370,302837
1008794,8409,80050,32415,69086,189960
1008795,94878,62546,16419,64287,238130
1008796,13680,43212,47448,87181,191521
1008797,37647,21858,73601,13771,146877
1008798,80834,35790,6168,85197,207989
1008799,5693,99112,89830,6432,201067
1008800,17386,69857,7394,55395,150032
1008801,80893,26039,73750,25441,206123
1008802,3440,68104,16575,94994,183113
1008803,51691,78629,34475,54617,219412
1008804,3635,12154,52666,84986,153441
1008805,96692,1111,16209,46772,160784
1008806,29037,12149,97003,30551,168740
1008807,36025,16529,10376,52169,115099
1008808,7419,687,19373,81546,109025
1008809,48975,19691,92215,81510,242391
1008810,48696,24241,87110,84249,244296
1008811,27620,47121,74619,64229,213589
1008812,17964,71427,66348,88034,243773
1008813,82826,52195,40614,30973,206608
1008814,36046,36902,81683,29015,183646
1008815,81309,13106,87600,64886,246901
1008816,89667,94305,25311,75501,284784
1008817,81559,6296,51635,92720,232210
1008818,52986,85546,86762,44123,269417
1008819,37958,97678,9328,61681,206645
1008820,32895,93990,92286,66699,285870
1008821,9936,39165,27419,62830,139350
1008822,96466,17424,58222,43554,215666
1008823,53339,32773,72236,77172,235520
1008824,65444,33349,10592,78354,187739
1008825,52365,44623,20732,478,118198
1008826,3988,8424,46399,31200,90011
1008827,55933,65012,90399,35423,246767
1008828,59488,18809,7381,23344,109022
1008829,82672,30045,30165,46906,189788
1008830,17721,50936,15254,83449,167360
1008831,28245,50989,9614,53242,142090
1008832,19632,1682,35340,6813,63467
1008833,51302,79646,78965,3631,213544
1008834,9625,23064,89388,92666,214743
1008835,89962,86668,18859,22589,218078
1008836,32436,94531,46105,81364,254436
1008837,96233,90269,6987,74631,268120
1008838,48815,83817,22504,19506,174642
1008839,7631,68121,23012,70204,168968
1008840,84098,80338,60732,1677,226845
1008841,70134,30349,58013,57595,216091
1008842,56689,18189,81196,59846,215920
1008843,89590,64458,35226,45041,234315
1008844,72399,8604,77779,88446,247228
1008845,92323,61048,78119,94366,325856
1008846,47096,4619,83906,58208,193829
1008847,4211,65153,39402,4960,113726
1008848,86210,29389,32443,31115,179157
1008849,51629,22846,39723,42373,156571
1008850,804,7076,94002,481,102363
1008851,76023,71346,55815,84147,287331
1008852,50155,52566,57357,36920,196998
1008853,95332,37260,33629,66924,233145
1008854,88419,18813,87841,91937,287010
1008855,15598,68889,90387,29008,203882
1008856,9144,30559,36128,79693,155524
1008857,91196,67526,27813,8606,195141
1008858,81828,58190,12803,6516,159337
1008859,49102,46023,68388,77186,240699
1008860,86323,20206,32201,59997,198727
1008861,27798,46052,97753,67815,239418
1008862,33663,53870,57410,85098,230041
1008863,70520,55978,13004,48831,188333
1008864,50338,29440,99405,35617,214800
1008865,92729,58992,80942,50310,282973
1008866,48366,27764,73249,27473,176852
1008867,5935,18576,43647,24883,93041
1008868,26763,35996,32003,13707,108469
1008869,88559,19946,69713,6001,184219
1008870,82434,81301,33889,61464,259088
1008871,20076,43184,50335,60940,174535
1008872,28484,98619,92842,91245,311190
1008873,66378,3931,41826,59791,171926
1008874,19258,91337,56728,94896,262219
1008875,80193,83271,77372,71603,312439
1008876,12022,76318,73765,13483,175588
1008877,63820,78951,34544,36003,213318
1008878,18177,59786,33438,61756,173157
1008879,69665,91749,82252,51086,294752
1008880,81469,42866,79518,89885,293738
1008881,28702,78208,45335,88352,240597
1008882,93669,63739,74181,85032,316621
1008883,30338,63530,47674,58342,199884
1008884,28839,50067,2052,12095,93053
1008885,38863,6229,40674,38698,124464
1008886,69124,79264,72199,37302,257889
1008887,21651,31858,36920,21615,112044
1008888,60704,43882,55664,32291,192541
1008889,26488,13986,81773,27043,149290
1008890,73970,35254,35637,71903,216764
1008891,43799,77162,23632,77471,222064
1008892,87658,53681,1672,5142,148153
1008893,39352,90277,16857,17045,163531
1008894,49612,71119,44294,49895,214920
1008895,3323,74869,84094,48799,211085
1008896,83134,45320,28789,24502,181745
1008897,39576,79758,141,81482,200957
1008898,8012,23967,1982,74357,108318
1008899,28733,75264,91499,56638,252134
1008900,10171,99568,25149,67627,202515
1008901,39143,74312,11543,97125,222123
1008902,52547,34029,19138,72846,178560
1008903,53644,3094,99519,49187,205444
1008904,91476,77087,8506,93203,270272
1008905,95151,55086,47395,10225,207857
1008906,57066,40982,60846,75035,233929
1008907,89563,19100,15932,92029,216624
1008908,90092,37929,39089,56682,223792
1008909,52819,5824,98410,61696,218749
1008910,49594,32528,19272,76956,178350
1008911,45496,78778,81517,15765,221556
1008912,18218,32191,14026,50809,115244
1008913,8038,16192,56094,91254,171578
1008914,70168,90610,45251,47460,253489
1008915,75069,53825,61091,68395,258380
1008916,16096,92084,40639,32437,181256
1008917,7342,77335,17132,690,102499
1008918,23696,35944,45007,36250,140897
1008919,53399,3361,12132,15574,84466
1008920,71628,36307,34832,22186,164953
1008921,48665,63054,95173,65878,272770
1008922,96463,33086,59417,4512,193478
1008923,84239,56616,25786,62697,229338
1008924,8903,28294,20143,60365,117705
1008925,72558,41448,97101,94375,305482
1008926,11877,27531,69375,47041,155824
1008927,86389,90957,14892,71970,264208
1008928,65319,48404,35878,45264,194865
1008929,16424,50919,77147,52712,197202
1008930,32124,59330,42503,66911,200868
1008931,66153,81766,30077,14938,192934
1008932,85951,37627,14488,51184,189250
1008933,68779,76388,17754,94259,257180
1008934,60400,29981,48917,50683,189981
1008935,14839,58230,32548,90930,196547
1008936,64373,74258,12790,36055,187476
1008937,50837,54304,9248,66,114455
1008938,71746,90500,86083,80288,328617
1008939,16095,52181,61019,11316,140611
1008940,66567,33244,77653,73546,251010
1008941,94538,52087,7509,46525,200659
1008942,68179,95082,76879,18843,258983
1008943,73358,11847,13268,1981,100454
1008944,79671,34448,17863,77129,209111
1008945,66289,73413,44627,33140,217469
1008946,97219,2740,36359,46769,183087
1008947,77722,41361,93900,44014,256997
1008948,7003,38919,85934,15607,147463
1008949,34815,20019,76312,80305,211451
1008950,93877,71967,17339,3802,186985
1008951,46084,44981,12821,76551,180437
1008952,40706,47932,23800,15836,128274
1008953,63198,91739,31944,30040,216921
1008954,38981,66877,30193,1357,137408
1008955,65181,84057,43935,90530,283703
1008956,62819,9414,41858,92315,206406
1008957,26886,48231,19694,97576,192387
1008958,44672,25543,37193,58063,165471
1008959,30683,84561,6953,4056,126253
1008960,35165,20227,65976,30592,151960
1008961,20574,61262,65472,31487,178795
1008962,87826,2715,65921,59916,216378
1008963,33594,93614,40553,31774,199535
1008964,37840,56340,95586,19957,209723
1008965,20007,35300,93404,24637,173348
1008966,61921,73483,14633,96352,246389
1008967,1370,54804,88541,53736,198451
1008968,2741,40172,47691,9001,99605
1008969,72613,86076,91946,51397,302032
1008970,19873,97482,63356,70248,250959
1008971,5352,51925,43227,24645,125149
1008972,47831,4302,97479,70795,220407
1008973,55256,74690,33073,30934,193953
1008974,86068,98526,90888,72395,347877
1008975,53831,28689,62369,10761,155650
1008976,13482,98392,98657,44190,254721
1008977,58802,87737,7530,23179,177248
1008978,98823,64037,1627,18320,182807
1008979,39736,79791,59538,28550,207615
1008980,33217,53407,44668,20965,152257
1008981,73855,26310,76731,13020,189916
1008982,6560,46682,81742,72834,207818
1008983,14097,94084,13277,50346,171804
1008984,70102,12216,92558,74107,248983
1008985,48305,97553,95790,40282,281930
1008986,46056,33712,24188,32215,136171
1008987,85106,22212,48806,27500,183624
1008988,14578,41317,48906,72184,176985
1008989,39113,87490,76159,40038,242800
1008990,90745,24320,12087,90663,217815
1008991,4889,26786,48851,31649,112175
1008992,22105,30851,5288,59956,118200
1008993,31014,60405,26283,70585,188287
1008994,43024,81344,32535,5039,161942
1008995,79548,57922,22435,21419,181324
1008996,51199,37810,10164,65415,164588
1008997,19731,38614,80373,42925,181643
1008998,325,73561,22787,12299,108972
1008999,97804,30332,11955,37249,177340
1009000,18596,14231,29518,43817,106162
1009001,72965,7252,37491,72510,190218
1009002,91747,72694,8954,2912,176307
1009003,91737,31300,72842,2065,197944
1009004,60955,39652,62591,22675,185873
1009005,3922,88557,28441,48049,168969
1009006,40478,32142,96303,44577,213500
1009007,38709,84282,45430,7316,175737
1009008,44905,82140,80485,43913,251443
1009009,2118,89934,66058,46858,204968
1009010,28318,32621,64711,34876,160526
1009011,13072,35597,42266,95723,186658
1009012,54692,93018,76862,87368,311940
1009013,96086,90309,51602,72231,310228
1009014,36513,78403,80632,83232,278780
1009015,50395,70219,15823,74383,210820
1009016,99259,81810,18070,53423,252562
1009017,76810,31316,39264,23149,170539
1009018,12777,73040,14025,79319,179161
1009019,5334,87817,36401,74759,204311
1009020,70389,2673,47066,79059,199187
1009021,9866,61415,81870,94159,247310
1009022,28958,99826,3547,25136,157467
1009023,19556,55121,11241,29799,115717
1009024,19755,13001,2367,85252,120375
1009025,37007,47960,99937,56867,241771
1009026,97067,65086,96283,70588,329024
1009027,56878,64983,67547,80276,269684
1009028,55154,72235,95962,18469,241820
1009029,96721,41204,40015,4866,182806
1009030,11305,39896,96022,38451,185674
1009031,99317,64899,81274,57604,303094
1009032,1530,40375,19900,62350,124155
1009033,30232,97043,63023,81193,271491
1009034,50885,92253,99228,36282,278648
1009035,68095,34716,47793,32712,183316
1009036,10756,33311,32704,32054,108825
1009037,35741,80273,32423,81356,229793
1009038,84906,43609,90002,87234,305751
1009039,40455,91120,19511,7875,158961
1009040,79006,60048,11128,90677,240859
1009041,27887,73270,91209,61582,253948
1009042,37510,11950,35137,21702,106299
1009043,65152,97292,70378,79105,311927
1009044,62879,17220,36935,46004,163038
1009045,23024,22574,81284,5574,132456
1009046,87879,75385,46550,78548,288362
1009047,8389,78893,73364,83028,243674
1009048,61588,34209,39043,26344,161184
1009049,85914,6226,59222,66297,217659
1009050,6397,27633,22535,51074,107639
1009051,38478,52760,79447,51358,222043
1009052,97276,6637,48512,84891,237316
1009053,64869,75658,43950,68010,252487
1009054,49472,31717,45270,6533,132992
1009055,57379,38307,77602,92443,265731
1009056,89270,83537,96804,62046,331657
1009057,34508,59845,7002,25529,126884
1009058,74479,12564,9444,77481,173968
1009059,40288,39463,44335,14480,138566
1009060,39594,65768,5507,20260,131129
1009061,47247,59901,54439,71154,232741
1009062,44133,53029,60943,46467,204572
1009063,36653,34288,76576,55005,202522
1009064,49306,92289,55229,80982,277806
1009065,30832,82738,49577,69902,233049
1009066,4428,14675,29763,93178,142044
1009067,42096,75208,97152,36182,250638
1009068,19004,4852,33732,33324,90912
1009069,99206,48587,48365,20129,216287
1009070,31584,62921,8732,54444,157681
1009071,41649,4587,2059,36578,84873
1009072,27441,31460,91558,82214,232673
1009073,91250,828,5580,15177,112835
1009074,42950,79020,84978,52691,259639
1009075,98223,63524,45991,975,208713
1009076,180,23676,57308,30757,111921
1009077,19832,46927,3653,40034,110446
1009078,3247,86503,5404,45527,140681
1009079,68920,98238,24047,61913,253118
1009080,82853,91125,13407,53188,240573
1009081,97424,13205,1169,59418,171216
1009082,97451,68254,43204,45671,254580
1009083,65245,14657,76692,11207,167801
1009084,15381,42173,95280,87335,240169
1009085,83003,88355,93481,93420,358259
1009086,98673,59204,63827,19873,241577
1009087,94219,86208,46959,91185,318571
1009088,27784,22288,12287,62437,124796
1009089,50356,20182,80569,33111,184218
1009090,22458,31350,39756,45021,138585
1009091,71853,86358,84411,98867,341489
1009092,32445,26793,88472,54773,202483
1009093,30150,87663,12116,94146,224075
1009094,43344,75572,87799,62649,269364
1009095,77773,52855,24031,47191,201850
1009096,70231,34796,92037,13782,210846
1009097,18705,32906,58545,86488,196644
1009098,71417,63100,70201,53503,258221
1009099,38781,83613,52021,95356,269771
1009100,72335,11401,91048,23425,198209
1009101,22595,83671,81302,99383,286951
1009102,8215,63857,23505,18305,113882
1009103,53614,63831,3064,14769,135278
1009104,64851,33886,39139,72632,210508
1009105,35379,52369,72158,57004,216910
1009106,92150,5277,58039,83353,238819
1009107,74450,47304,84639,16823,223216
1009108,82755,93575,74192,83529,334051
1009109,53543,10064,52100,95546,211253
1009110,85256,2812,87868,4078,180014
1009111,10143,4645,65123,15292,95203
1009112,65806,61588,82580,66235,276209
1009113,56797,95917,68408,9598,230720
1009114,27542,79281,91430,34661,232914
1009115,29945,35666,96117,42346,204074
1009116,43556,46838,3514,36569,130477
1009117,20934,91746,7299,37244,157223
1009118,60149,6724,3478,55703,126054
1009119,43570,99128,58034,29297,230029
1009120,86362,67228,66224,67096,286910
1009121,49400,28289,89027,60162,226878
1009122,18125,42709,37437,68694,166965
1009123,83327,93675,34931,78959,290892
1009124,49005,28889,34996,64344,177234
1009125,21765,20125,21498,72545,135933
1009126,52782,99136,65043,31919,248880
1009127,67825,10086,75717,3390,157018
1009128,8146,30843,71334,98010,208333
1009129,82309,21315,80558,73879,258061
1009130,35284,23498,33973,63482,156237
1009131,76374,54420,20277,33369,184440
1009132,91647,23374,47484,58536,221041
1009133,10283,12307,76181,90478,189249
1009134,48707,85187,85169,68728,287791
1009135,88969,50901,83643,44475,267988
1009136,75975,13565,12116,65496,167152
1009137,43593,65305,47149,96058,252105
1009138,29167,7934,18171,89325,144597
1009139,3528,8503,60714,86642,159387
1009140,81549,41033,15250,19850,157682
1009141,22677,88784,73885,94089,279435
1009142,8888,47818,76103,63784,196593
1009143,59512,61894,5782,11131,138319
1009144,22356,5768,78036,65817,171977
1009145,99983,60876,32152,26171,219182
1009146,58751,20094,36861,60268,175974
1009147,76464,52243,65331,48813,242851
1009148,93812,52266,21867,43365,211310
1009149,86670,98198,78806,26204,289878
1009150,48325,86296,50085,1960,186666
1009151,7700,52806,41416,32827,134749
1009152,5393,58039,79958,43873,187263
1009153,31211,11061,64929,30254,137455
1009154,6997,46202,7663,59192,120054
1009155,94374,95176,80415,95306,365271
1009156,52958,65028,87219,77016,282221
1009157,28419,18633,53879,43741,144672
1009158,5866,27283,75797,36815,145761
1009159,68587,77435,90802,21799,258623
1009160,53015,50432,23247,74455,201149
1009161,72330,58719,16523,59786,207358
1009162,1041,58639,66784,57610,184074
1009163,75299,21639,62024,34956,193918
1009164,11432,54683,29273,3677,99065
1009165,6341,28322,61423,6892,102978
1009166,33365,45832,19297,59824,158318
1009167,13154,99182,10279,25330,147945
1009168,70786,74385,99580,15377,260128
1009169,31735,46883,29276,74143,182037
1009170,6057,76625,67869,9745,160296
1009171,60192,26319,61356,42475,190342
1009172,73578,49537,68850,8006,199971
1009173,76911,98714,32618,49730,257973
1009174,65395,90927,40072,29629,226023
1009175,2222,85114,48881,79132,215349
1009176,49195,97067,48087,43311,237660
1009177,69428,85237,29570,95987,280222
1009178,90163,69250,57322,68797,285532
1009179,97432,77426,92030,31172,298060
1009180,33242,90298,30176,78932,232648
1009181,74770,32605,27264,79343,213982
1009182,36523,1287,61418,23105,122333
1009183,80134,72465,85133,32619,270351
1009184,21157,87797,84893,57419,251266
1009185,60186,44544,21756,75929,202415
1009186,46375,4718,80875,36638,168606
1009187,41052,78743,36252,86980,243027
1009188,41061,30863,6095,83228,161247
1009189,63742,66600,80635,13762,224739
1009190,89276,61288,98648,97314,346526
1009191,53461,18675,85983,54475,212594
1009192,33433,3187,31456,21164,89240
1009193,61105,15827,84720,11060,172712
1009194,47921,41024,80642,76407,245994
1009195,94223,78195,320,74586,247324
1009196,37029,89717,33718,81292,241756
1009197,25093,41673,28217,6636,101619
1009198,80477,37006,54676,45727,217886
1009199,46519,78844,30780,47139,203282
1009200,31596,34800,66993,51883,185272
1009201,99114,8364,32820,64888,205186
1009202,90502,28853,55821,97020,272196
1009203,60239,43279,6941,66213,176672
1009204,39604,95197,38066,7311,180178
1009205,35417,41448,94104,59921,230890
1009206,22524,1011,10857,38288,72680
1009207,696,27914,9043,78081,115734
1009208,45353,34862,46169,21143,147527
1009209,13206,52745,41672,37349,144972
1009210,55250,37440,43992,54529,191211
1009211,35623,64017,92723,19378,211741
1009212,26529,95759,48250,43180,213718
1009213,21749,60803,10672,80837,174061
1009214,50570,24532,11116,33296,119514
1009215,81683,46361,74586,92484,295114
1009216,39235,4255,66766,23195,133451
1009217,36602,90492,27104,57997,212195
1009218,79758,25898,18141,28037,151834
1009219,16449,41328,56606,19083,133466
1009220,95317,71278,93228,96363,356186
1009221,67413,30822,46497,20891,165623
1009222,3307,77435,38169,56130,175041
1009223,49129,90207,12566,43507,195409
1009224,75258,19970,4911,71285,171424
1009225,71374,19765,6789,48588,146516
1009226,47557,52094,6628,65970,172249
1009227,94096,51962,43391,80365,269814
1009228,60553,34882,48397,97386,241218
1009229,93453,52300,47970,94589,288312
1009230,3972,65020,84748,40793,194533
1009231,91324,61337,12351,54371,219383
1009232,44680,94995,73150,85080,297905
1009233,54616,96122,37695,71187,259620
1009234,6807,76468,16602,18120,117997
1009235,14629,94456,20155,69880,199120
1009236,36116,11688,65057,87944,200805
1009237,3932,395,80907,52456,137690
1009238,20986,66634,12524,58554,158698
1009239,25036,19365,65812,76599,186812
1009240,43205,90091,14942,83894,232132
1009241,20929,64174,2084,79285,166472
1009242,12546,19709,23318,27301,82874
1009243,87721,66224,19123,40007,213075
1009244,27855,14328,12995,16045,71223
1009245,44944,77642,12715,5247,140548
1009246,66852,98399,20754,39240,225245
1009247,65304,39238,13654,44241,162437
1009248,4553,31625,47075,92670,175923
1009249,16194,89251,39983,65059,210487
1009250,33968,20207,2225,79753,136153
1009251,10006,23471,20320,67349,121146
1009252,51465,16542,41231,32260,141498
1009253,95423,49411,72300,29354,246488
1009254,51253,29685,16190,78018,175146
1009255,30076,91461,58151,54596,234284
1009256,41561,13819,25055,99856,180291
1009257,10098,58917,79285,35807,184107
1009258,25005,97528,34533,73853,230919
1009259,91818,89532,96797,28622,306769
1009260,97638,90773,43011,27907,259329
1009261,96018,26117,52886,33932,208953
1009262,10835,54339,81458,21508,168140
1009263,73408,76193,97229,35941,282771
1009264,87324,29279,30384,20590,167577
1009265,69887,40903,72504,12226,195520
1009266,13915,92929,95983,1511,204338
1009267,62327,9743,46588,94632,213290
1009268,69434,53866,95814,25452,244566
1009269,35032,17958,96335,46597,195922
1009270,1188,41491,26242,21483,90404
1009271,34244,92799,52715,18935,198693
1009272,49392,55604,15931,93457,214384
1009273,54674,92351,23682,52046,222753
1009274,41116,68165,58220,37494,204995
1009275,63127,7599,77650,59089,207465
1009276,48424,30393,68927,12358,160102
1009277,76432,6133,9697,15741,108003
1009278,9439,78135,29614,31997,149185
1009279,95052,80905,31589,48764,256310
1009280,43595,40204,25068,10132,118999
1009281,52226,50895,29892,22577,155590
1009282,63022,28456,12443,36714,140635
1009283,36449,30089,51769,78848,197155
1009284,88260,35715,94443,32687,251105
1009285,51393,16478,13805,1033,82709
1009286,84152,59990,44721,35297,224160
1009287,18822,3477,18981,7994,49274
1009288,46584,67864,29304,6395,150147
1009289,96398,5403,47319,3693,152813
1009290,637,65286,25205,68870,159998
1009291,57810,5005,81234,46656,190705
1009292,99190,48104,14656,2903,164853
1009293,63677,82868,50292,33709,230546
1009294,20055,48416,42141,20564,131176
1009295,82503,67312,42315,24628,216758
1009296,55094,99126,14174,1222,169616
1009297,7930,33173,81166,38982,161251
1009298,97143,36843,63460,61878,259324
1009299,24288,24076,39253,91944,179561
1009300,30879,87631,81754,64832,265096
1009301,47063,93598,86530,98927,326118
1009302,27581,78275,80585,17606,204047
1009303,15851,75206,43919,6278,141254
1009304,22156,89609,20902,11450,144117
1009305,769,86134,55472,69739,212114
1009306,40443,67825,33004,70493,211765
1009307,42604,98040,18127,43613,202384
1009308,52748,17396,76402,24823,171369
1009309,88693,14271,86064,59143,248171
1009310,90448,66015,89429,85484,331376
1009311,30481,78773,76473,2983,188710
1009312,70356,18501,4403,62070,155330
1009313,65930,75387,12803,99403,253523
1009314,12083,93330,58997,68015,232425
1009315,81101,99428,10994,3901,195424
1009316,51227,94895,83729,26079,255930
1009317,5407,82855,85797,2691,176750
1009318,52684,18871,49095,18633,139283
1009319,61775,55652,74381,31784,223592
1009320,81763,83187,82232,2620,249802
1009321,67261,74970,52591,25097,219919
1009322,87520,34437,92847,48808,263612
1009323,29822,62182,44106,74291,210401
1009324,44749,91149,7771,72378,216047
1009325,36737,80602,61393,44173,222905
1009326,21284,72084,64779,82301,240448
1009327,32184,23130,52870,47411,155595
1009328,31696,57467,67611,42602,199376
1009329,41485,97487,44055,58824,241851
1009330,7794,48352,66313,79990,202449
1009331,23424,32221,91124,82839,229608
1009332,79663,45857,50422,85640,261582
1009333,85708,40302,67139,59388,252537
1009334,5573,64846,48494,56668,175581
1009335,87695,25905,48285,76227,238112
1009336,5267,14438,74298,59931,153934
1009337,47031,88012,32771,95441,263255
1009338,22000,79592,24293,10784,136669
1009339,81664,88539,8998,76310,255511
1009340,82341,67582,4860,28439,183222
1009341,42929,18689,3010,23284,87912
1009342,51301,26996,4089,69083,151469
1009343,41826,63360,9118,22637,136941
1009344,76370,74231,24487,51333,226421
1009345,56943,34298,12810,78550,182601
1009346,13089,18138,52271,13812,97310
1009347,73510,69190,77795,94097,314592
1009348,86984,85391,45355,88531,306261
1009349,82194,91081,69272,30825,273372
1009350,93290,69688,28412,20695,212085
1009351,93215,18705,41908,37346,191174
1009352,89557,14576,56350,34372,194855
1009353,29074,53997,50307,30471,163849
1009354,85752,7873,82282,57054,232961
1009355,54012,23252,80148,22343,179755
1009356,93147,68732,79391,47669,288939
1009357,4692,91574,3672,9089,109027
1009358,9323,81194,56972,68211,215700
1009359,96495,59423,91982,60,247960
1009360,77039,62921,85408,72650,298018
1009361,88713,5299,79402,30223,203637
1009362,58870,51227,43872,6706,160675
1009363,85448,14770,44229,67628,212075
1009364,5290,57001,46646,28356,137293
1009365,19199,72829,16738,86009,194775
1009366,37013,5240,60251,65420,167924
1009367,15991,21608,1234,26992,65825
1009368,54814,89833,34405,58586,237638
1009369,6635,13841,27547,81109,129132
1009370,45239,64306,44064,93385,246994
1009371,18896,98633,55363,180,173072
1009372,90957,36017,41209,55551,223734
1009373,63135,61414,58390,17408,200347
1009374,25102,93954,71890,31650,222596
1009375,64100,89664,32562,36425,222751
1009376,2126,16189,82483,97492,198290
1009377,3345,15763,25633,67224,111965
1009378,27630,30878,11852,66377,136737
1009379,12007,50908,77064,37758,177737
1009380,27737,1062,50615,63443,142857
1009381,40222,98548,13063,51337,203170
1009382,14340,2608,24905,5951,47804
1009383,57391,10658,93486,81735,243270
1009384,44238,61846,26924,62753,195761
1009385,41531,96730,23530,66710,228501
1009386,57221,4885,57,9651,71814
1009387,32523,16698,48692,35696,133609
1009388,33757,69433,61581,24080,188851
1009389,72298,76347,76063,81255,305963
1009390,82227,57837,81074,85303,306441
1009391,11853,99404,36989,90510,238756
1009392,13449,53773,18628,97700,183550
1009393,68096,21479,23386,89084,202045
1009394,44211,80803,55059,69041,249114
1009395,71596,80379,35230,48309,235514
1009396,95255,95173,8337,11635,210400
1009397,47348,98817,58132,2053,206350
1009398,30205,49902,5149,10118,95374
1009399,48015,64051,1586,22381,136033
1009400,77333,22840,7080,67317,174570
1009401,59387,43023,2749,30264,135423
1009402,24543,31149,1688,90537,147917
1009403,20711,77201,60858,20700,179470
1009404,45580,55697,75944,92492,269713
1009405,28001,67246,44584,74329,214160
1009406,95685,24934,96499,1706,218824
1009407,15298,41580,2426,65846,125150
1009408,16413,56489,11170,13093,97165
1009409,19006,92522,2904,80552,194984
1009410,97131,52508,87087,33897,270623
1009411,26367,22036,37583,87804,173790
1009412,99111,8348,94589,1512,203560
1009413,32106,53484,76926,96923,259439
1009414,15837,87473,6688,46749,156747
1009415,36865,19462,12833,58706,127866
1009416,86384,51681,9494,16375,163934
1009417,68481,44126,48224,74241,235072
1009418,92905,77228,44305,34957,249395
1009419,4686,40120,64419,94179,203404
1009420,30768,7002,70269,91353,199392
1009421,11760,91433,93962,96873,294028
1009422,39362,25347,31056,16334,112099
1009423,95842,20200,7194,5162,128398
1009424,33655,39335,34080,73438,180508
1009425,68028,50985,73666,92998,285677
1009426,16860,64400,30909,8856,121025
1009427,42736,8371,48727,96962,196796
1009428,31797,79021,32363,95208,238389
1009429,64836,73207,79027,84013,301083
1009430,22558,83541,27929,99127,233155
1009431,41854,96485,41483,27970,207792
1009432,61635,11765,74434,30610,178444
1009433,50738,69289,14996,91734,226757
1009434,35675,96090,21375,6746,159886
1009435,80041,87722,29676,65302,262741
1009436,59144,30165,29534,1899,120742
1009437,69661,12454,34933,98799,215847
1009438,45028,38016,14970,95345,193359
1009439,3616,55542,1718,29738,90614
1009440,79933,73288,60324,24480,238025
1009441,74280,53313,1896,78017,207506
1009442,20040,83157,5285,81951,190433
1009443,52007,63758,40140,6232,162137
1009444,98975,42264,73878,68562,283679
1009445,60963,9299,38805,48910,157977
1009446,1808,42136,18487,86198,148629
1009447,14499,32103,14755,30963,92320
1009448,56155,64614,18447,72565,211781
1009449,78421,95816,21725,61515,257477
1009450,16928,1580,73996,69268,161772
1009451,58479,40417,91555,33353,223804
1009452,76754,33185,76031,52060,238030
1009453,43663,54044,71310,20630,189647
1009454,87973,55554,5491,4521,153539
1009455,52943,73656,82558,82693,291850
1009456,59219,37184,45292,96616,238311
1009457,70730,40441,53253,78556,242980
1009458,74683,7025,11872,75695,169275
1009459,80011,67787,22937,48497,219232
1009460,33889,79942,62269,84093,260193
1009461,16790,26604,84067,94741,222202
1009462,22724,36975,57361,94941,212001
1009463,76634,23779,4795,43419,148627
1009464,57755,99786,30781,57876,246198
1009465,42800,79946,1042,91566,215354
1009466,82766,4697,29677,67036,184176
1009467,5993,55105,7492,23749,92339
1009468,95934,7976,48321,77490,229721
1009469,77694,69897,42663,54653,244907
1009470,79607,50422,71617,24600,226246
1009471,24988,98380,67753,25301,216422
1009472,72177,3471,27648,4261,107557
1009473,88559,49834,53143,43246,234782
1009474,15023,78397,2070,72568,168058
1009475,90277,12291,18104,6698,127370
1009476,49276,65870,27130,67887,210163
1009477,6284,59306,44209,14781,124580
1009478,12607,93669,4013,77641,187930
1009479,3747,38091,87460,92272,221570
1009480,73166,82286,79805,22256,257513
1009481,92578,16379,16172,83498,208627
1009482,85742,84198,32887,69586,272413
1009483,80710,90904,89731,26759,288104
1009484,24413,29484,16342,66036,136275
1009485,14787,16136,81572,76718,189213
1009486,50921,26893,46290,31646,155750
1009487,11719,39367,6271,22919,80276
1009488,39795,94269,60230,36248,230542
1009489,41908,49575,35436,94362,221281
1009490,29381,61731,32037,60520,183669
1009491,60106,16243,20847,123,97319
1009492,26674,70826,9152,54343,160995
1009493,66158,29045,25072,16743,137018
1009494,34532,24722,38947,13174,111375
1009495,31490,7043,74853,20744,134130
1009496,22192,19136,83460,51049,175837
1009497,99264,69251,98395,57014,323924
1009498,98103,59205,70010,73549,300867
1009499,21421,25190,7858,16705,71174
1009500,45134,39621,79850,41989,206594
1009501,32227,46011,25224,235,103697
1009502,23713,96151,86642,98639,305145
1009503,80125,76889,32419,5999,195432
1009504,66779,69434,67710,74645,278568
1009505,7241,58770,28385,95485,189881
1009506,7102,78104,11345,86869,183420
1009507,6343,23016,28376,14423,72158
1009508,54212,60676,35263,30154,180305
1009509,34969,50238,61718,74629,221554
1009510,28066,93357,28765,58691,208879
1009511,65960,11572,82283,764,160579
1009512,71479,51503,31397,95583,249962
1009513,71823,6850,25819,64267,168759
1009514,31160,81307,43595,42426,198488
1009515,82663,18568,1021,86320,188572
1009516,76843,60274,82075,7679,226871
1009517,33069,26130,26344,48868,134411
1009518,51777,60784,52251,37118,201930
1009519,70896,97253,45293,26525,239967
1009520,5269,43316,2173,51219,101977
1009521,70449,16619,10286,12213,109567
1009522,9148,84147,80857,17568,191720
1009523,29847,42944,22766,4297,99854
1009524,54990,22832,10531,41564,129917
1009525,88245,12144,75949,73667,250005
1009526,13983,72094,84992,97636,268705
1009527,77721,78679,35293,29628,221321
1009528,12075,77782,66557,43116,199530
1009529,30532,27840,55938,46781,161091
1009530,80039,74892,49107,70860,274898
1009531,55078,7242,43828,43486,149634
1009532,59000,5250,61994,37854,164098
1009533,174,18411,56035,50737,125357
1009534,84576,96329,98055,40746,319706
1009535,12110,71741,31031,98927,213809
1009536,94337,79562,51097,65217,290213
1009537,17341,72923,29931,11333,131528
1009538,81032,77282,88956,27279,274549
1009539,9110,86351,9381,30654,135496
1009540,48957,2772,59779,12647,124155
1009541,54911,20334,65128,33029,173402
1009542,53445,71832,95285,46522,267084
1009543,50839,31398,85274,88816,256327
1009544,28982,1460,99760,19811,150013
1009545,67068,39359,311,88686,195424
1009546,16145,38386,44760,32363,131654
1009547,29110,66624,18245,8601,122580
1009548,5769,14905,75579,81423,177676
1009549,74251,97573,27741,48230,247795
1009550,53777,26625,35794,12701,128897
1009551,27232,45685,10790,1418,85125
1009552,44570,9099,56136,36782,146587
1009553,79924,60157,83326,17028,240435
1009554,35015,15079,25432,63405,138931
1009555,75255,21218,96100,77198,269771
1009556,83022,97132,41812,3683,225649
1009557,42302,53172,18334,31240,145048
1009558,12877,89386,31814,66646,200723
1009559,62116,88406,82818,33050,266390
1009560,76372,93526,24173,376,194447
1009561,15312,94683,43278,28456,181729
1009562,19082,49005,20238,79908,168233
1009563,45516,90328,77388,78954,292186
1009564,72554,49304,57177,73850,252885
1009565,49744,19259,46178,20284,135465
1009566,29352,41780,22745,92675,186552
1009567,76175,2017,20220,72221,170633
1009568,53745,86482,81951,29072,251250
1009569,46103,81424,55171,6114,188812
1009570,74978,84522,87595,45995,293090
1009571,18439,19183,88309,3766,129697
1009572,84079,8612,66358,22914,181963
1009573,60442,55611,48918,75697,240668
1009574,60778,91606,72527,86284,311195
1009575,77058,55455,12580,68510,213603
1009576,71651,29358,34996,56428,192433
1009577,75168,2059,52464,37486,167177
1009578,26012,93737,23396,594,143739
1009579,88131,79935,98470,26209,292745
1009580,29967,2136,84618,63934,180655
1009581,67400,27722,83766,20182,199070
1009582,49224,41132,97907,22746,211009
1009583,60482,8881,67664,79116,216143
1009584,51692,22761,65821,12965,153239
1009585,65959,86543,36424,57219,246145
1009586,65651,24433,65016,92363,247463
1009587,56250,87367,88388,36148,268153
1009588,46613,6925,10000,27469,91007
1009589,53626,99713,42766,61650,257755
1009590,19321,91983,85740,95339,292383
1009591,29233,47724,96730,59088,232775
1009592,29353,81299,605,43690,154947
1009593,21309,93287,71129,24161,209886
1009594,32830,5196,82708,79750,200484
1009595,82089,28331,68034,6441,184895
1009596,64361,78213,18241,39752,200567
1009597,70086,22095,56367,17742,166290
1009598,69768,7523,81549,56994,215834
1009599,41909,63401,24090,38020,167420
1009600,84761,94261,41627,43120,263769
1009601,57705,76958,44009,10661,189333
1009602,19961,61271,47649,14536,143417
1009603,34294,17740,8525,90805,151364
1009604,11888,45763,29593,841,88085
1009605,74026,22330,69458,90263,256077
1009606,88645,67112,54667,56082,266506
1009607,79338,6925,85498,90818,262579
1009608,68679,96893,98048,30283,293903
1009609,48184,32251,31910,82134,194479
1009610,92722,61884,89833,37510,281949
1009611,53594,65456,54306,99426,272782
1009612,87539,82796,34839,85583,290757
1009613,73153,44542,13814,74038,205547
1009614,2468,50149,28740,83095,164452
1009615,87314,11320,52251,61820,212705
1009616,74726,60775,74167,91540,301208
1009617,38986,96729,7688,9596,152999
1009618,96551,43096,51705,75007,266359
1009619,3001,99987,59811,58487,221286
1009620,64768,92699,29707,36804,223978
1009621,93874,42913,47028,94202,278017
1009622,87636,4289,31998,15758,139681
1009623,10026,14201,83977,97629,205833
1009624,73635,91556,34388,12075,211654
1009625,12760,41990,78413,36081,169244
1009626,94771,69982,81373,36213,282339
1009627,47779,59192,92142,56576,255689
1009628,76756,50369,38883,46964,212972
1009629,85703,14067,42724,47340,189834
1009630,30106,56547,49459,30934,167046
1009631,76917,28402,25527,21250,152096
1009632,5286,53452,58436,77751,194925
1009633,89288,1706,19782,43032,153808
1009634,11642,3090,88229,66629,169590
1009635,34572,52381,51,36357,123361
1009636,90396,16372,5918,93703,206389
1009637,24185,78226,98250,90474,291135
1009638,52007,62990,44547,54772,214316
1009639,43730,6829,53653,71786,175998
1009640,23536,30501,10773,99583,164393
1009641,59949,40416,8657,13405,122427
1009642,98558,43561,22424,86280,250823
1009643,99623,26867,26239,81669,234398
1009644,37278,10023,41946,26458,115705
1009645,98090,34587,2776,90177,225630
1009646,13140,40914,2215,47405,103674
1009647,28745,54967,81442,98810,263964
1009648,22644,4755,2991,11677,42067
1009649,50989,69808,96276,71965,289038
1009650,22337,75363,82019,35488,215207
1009651,91403,59786,2488,90659,244336
1009652,36279,91001,92058,15229,234567
1009653,54155,72585,56387,81945,265072
1009654,10667,30661,10028,75,51431
1009655,86686,15847,57016,42155,201704
1009656,68535,75712,93093,72225,309565
1009657,67354,93669,22185,90665,273873
1009658,6674,33125,51015,88653,179467
1009659,29833,7829,46726,40294,124682
1009660,85173,23236,89319,53719,251447
1009661,43369,17466,28791,99451,189077
1009662,46559,38569,17897,26132,129157
1009663,37260,37166,51564,98066,224056
1009664,54967,18873,67819,38289,179948
1009665,55208,76431,43144,26870,201653
1009666,10005,87614,64250,41620,203489
1009667,24286,83032,64531,95066,266915
1009668,73458,22635,13828,28530,138451
1009669,69615,34809,10061,48433,162918
1009670,55274,85298,25362,2540,168474
1009671,83526,64239,15848,30211,193824
1009672,57348,11760,91043,33688,193839
1009673,14329,35561,28915,29754,108559
1009674,22502,44015,50084,94449,211050
1009675,25300,83618,50584,22271,181773
1009676,70047,11237,25047,45043,151374
1009677,18672,19276,39152,90157,167257
1009678,7502,7650,14172,86333,115657
1009679,15990,63668,16266,12952,108876
1009680,18713,20115,52087,43796,134711
1009681,5378,17963,73317,48186,144844
1009682,2022,90019,69179,18885,180105
1009683,42914,71777,45154,70003,229848
1009684,49070,12129,8550,11052,80801
1009685,17847,84077,29023,19054,150001
1009686,49208,48944,46566,14308,159026
1009687,46773,38695,49176,50838,185482
1009688,77968,73718,68539,46361,266586
1009689,45595,73389,97603,38307,254894
1009690,57482,63084,75076,43970,239612
1009691,44551,58848,6414,48135,157948
1009692,31173,99063,69065,17228,216529
1009693,9004,4495,15083,10185,38767
1009694,76666,41190,7171,42552,167579
1009695,63402,83505,11557,23600,182064
1009696,51387,37267,10411,36752,135817
1009697,94614,94876,53737,44835,288062
1009698,56548,45213,77202,33267,212230
1009699,79341,17667,75333,13204,185545
1009700,47995,25666,73201,86866,233728
1009701,13534,32766,12643,56701,115644
1009702,1190,45686,703,27449,75028
1009703,60858,17286,30509,41344,149997
1009704,29413,23203,8642,64207,125465
1009705,86208,86361,29677,25990,228236
1009706,44502,75076,3267,39377,162222
1009707,71482,68314,7761,73014,220571
1009708,49812,76132,4552,61062,191558
1009709,402,59603,52009,78857,190871
1009710,78378,51915,51336,10641,192270
1009711,61538,63006,85433,60239,270216
1009712,19089,52597,39153,81756,192595
1009713,40255,34816,8923,63003,146997
1009714,40562,80592,56795,95148,273097
1009715,93967,75829,28128,12012,209936
1009716,71627,80006,32661,37745,222039
1009717,11756,18601,66349,74455,171161
1009718,75257,56114,80549,5894,217814
1009719,68792,77278,81602,98771,326443
1009720,70824,30396,79226,18770,199216
1009721,73306,49055,41076,23613,187050
1009722,81528,23682,60524,4516,170250
1009723,4979,14779,21799,24117,65674
1009724,42963,7196,91289,75885,217333
1009725,73277,94025,54300,27522,249124
1009726,84502,17727,73368,30705,206302
1009727,57782,30778,77661,30291,196512
1009728,55300,17591,12125,54702,139718
1009729,73634,97161,71272,11252,253319
1009730,3093,23390,72559,53146,152188
1009731,69401,98524,40151,68595,276671
1009732,82636,10778,15249,54338,163001
1009733,36746,53187,7614,34046,131593
1009734,40492,3977,90404,53958,188831
1009735,18885,55031,64054,48009,185979
1009736,73791,50354,84109,73757,282011
1009737,41339,18714,6775,85220,152048
1009738,73212,95656,55923,22043,246834
1009739,14331,50383,16932,707,82353
1009740,22492,26923,5133,42473,97021
1009741,78640,49434,91006,98780,317860
1009742,10370,52141,26102,33262,121875
1009743,84858,11281,33935,31888,161962
1009744,34070,97838,23426,90281,245615
1009745,39947,73037,99528,41881,254393
1009746,49277,42154,96613,64373,252417
1009747,93683,6550,39863,83557,223653
1009748,96546,1334,44203,33043,175126
1009749,43256,38978,59132,97660,239026
1009750,29239,564,96694,79901,206398
1009751,85888,77962,19025,4004,186879
1009752,64784,23327,82661,17266,188038
1009753,76404,84725,71833,63106,296068
1009754,45891,20465,53644,72425,192425
1009755,42899,23173,97587,31278,194937
1009756,97063,32519,83363,87881,300826
1009757,60396,23439,78000,35236,197071
1009758,41552,42145,35083,22747,141527
1009759,80844,99753,35888,44880,261365
1009760,77479,42295,70868,42330,232972
1009761,91449,6747,46316,68857,213369
1009762,29381,36208,6907,31789,104285
1009763,73059,8210,15756,52894,149919
1009764,57046,75067,77913,88591,298617
1009765,24819,25364,44469,17680,112332
1009766,12867,72709,79958,16555,182089
1009767,62968,44134,49633,37779,194514
1009768,65296,10693,51410,40881,168280
1009769,71933,34324,44672,50011,200940
1009770,73007,35299,20886,41387,170579
1009771,58355,74645,76262,22255,231517
1009772,2008,25956,79921,93463,201348
1009773,62138,38694,74148,49557,224537
1009774,7881,29454,67315,7152,111802
1009775,75923,60967,54385,63795,255070
1009776,83521,49210,41020,5908,179659
1009777,12383,17366,71849,12807,114405
1009778,68912,53693,4384,50242,177231
1009779,16089,38828,17250,53330,125497
1009780,84280,1585,47037,17546,150448
1009781,73901,12844,16408,28279,131432
1009782,84323,344,36236,48407,169310
1009783,29961,64247,4474,35129,133811
1009784,98866,91781,9805,34528,234980
1009785,40890,90836,28303,85153,245182
1009786,34332,35882,9193,28028,107435
1009787,22448,40022,80910,92374,235754
1009788,70775,12830,14763,80906,179274
1009789,9250,80694,84803,70175,244922
1009790,34018,1693,31104,92595,159410
1009791,81929,6314,53827,22191,164261
1009792,75586,83763,77806,74605,311760
1009793,53734,60466,23906,87164,225270
1009794,59237,35020,42116,20186,156559
1009795,98191,1075,83802,50773,233841
1009796,69199,97495,52797,36624,256115
1009797,60759,77683,69261,44730,252433
1009798,43733,89233,7478,86665,227109
1009799,45345,13302,50529,5648,114824
1009800,27890,98318,24790,32411,183409
1009801,90834,83936,88215,40964,303949
1009802,24777,51819,91983,30986,199565
1009803,97949,69126,47458,73084,287617
1009804,91751,44260,84532,69706,290249
1009805,37666,2218,96070,3985,139939
1009806,5244,33126,38095,28323,104788
1009807,42604,11646,61727,61882,177859
1009808,87535,17452,25226,32899,163112
1009809,23503,94480,531,47430,165944
1009810,55335,27945,53224,41811,178315
1009811,72331,99631,47643,88538,308143
1009812,96475,24041,72272,34150,226938
1009813,80228,59654,89424,35114,264420
1009814,45235,70518,12791,62963,191507
1009815,24745,82167,64702,29437,201051
1009816,69633,85022,45634,87075,287364
1009817,61807,37767,23409,79339,202322
1009818,43138,94070,2578,29739,169525
1009819,76185,83012,45663,71991,276851
1009820,32374,66084,76519,52003,226980
1009821,96098,99666,86485,3352,285601
1009822,68789,64521,25473,38570,197353
1009823,25892,43444,21342,11347,102025
1009824,34743,22944,80027,2152,139866
1009825,36568,85294,58774,66061,246697
1009826,18587,13393,19149,49801,100930
1009827,82120,12913,90334,11945,197312
1009828,18381,46858,86305,52272,203816
1009829,16195,68685,48618,19217,152715
1009830,15840,83371,29645,64460,193316
1009831,52118,90770,64333,25709,232930
1009832,12108,99852,65177,50752,227889
1009833,52937,30153,75245,82377,240712
1009834,31219,89004,93955,77271,291449
1009835,94855,45424,18113,90858,249250
1009836,90621,18567,65796,15812,190796
1009837,58644,40329,20166,37002,156141
1009838,85483,5868,72275,46520,210146
1009839,60581,91084,30334,36346,218345
1009840,93105,69047,51811,19758,233721
1009841,13735,89202,62187,63096,228220
1009842,88728,17547,36049,72787,215111
1009843,81734,9653,65333,99392,256112
1009844,85735,90424,30414,14779,221352
1009845,36838,82856,90935,76649,287278
1009846,29715,92283,55030,21347,198375
1009847,5311,91771,95063,80034,272179
1009848,77928,27802,96715,81044,283489
1009849,30176,55151,46030,22626,153983
1009850,30834,24768,84636,65615,205853
1009851,6515,69760,65537,69663,211475
1009852,79667,64218,98629,14279,256793
1009853,92049,10863,34980,65785,203677
1009854,83317,99995,67549,5657,256518
1009855,3996,92977,78084,68337,243394
1009856,21530,28363,48367,69158,167418
1009857,88085,80332,21296,64010,253723
1009858,17666,56543,50674,67722,192605
1009859,84115,16073,23128,32576,155892
1009860,26618,50756,51298,95973,224645
1009861,90934,2573,82457,9047,185011
1009862,1748,29879,10529,92380,134536
1009863,92401,89733,47889,44441,274464
1009864,29164,38635,50997,44663,163459
1009865,3491,46946,11083,48425,109945
1009866,52664,89249,91154,79462,312529
1009867,5526,11981,72342,454,90303
1009868,3455,17351,7195,54033,82034
1009869,20672,19330,32602,75203,147807
1009870,8717,8410,26901,36310,80338
1009871,20377,54013,79128,93527,247045
1009872,70830,98346,48126,83247,300549
1009873,21520,38117,48315,36242,144194
1009874,99601,35595,64616,38966,238778
1009875,59906,60108,71783,54960,246757
1009876,16267,76506,64404,23236,180413
1009877,44951,44765,78422,6740,174878
1009878,52775,97339,51037,57105,258256
1009879,69822,86839,12600,390,169651
1009880,87871,76721,34500,49381,248473
1009881,86405,28397,69631,41598,226031
1009882,26072,68804,54658,89169,238703
1009883,98516,67565,64529,50557,281167
1009884,58422,71364,82495,92882,305163
1009885,13149,83457,10729,45222,152557
1009886,95866,3040,9434,37986,146326
1009887,78304,21374,64241,20115,184034
1009888,30072,90164,80711,68305,269252
1009889,46560,43240,32433,13077,135310
1009890,37822,54005,22343,88826,202996
1009891,15911,92957,18926,28195,155989
1009892,19261,12947,53598,92296,178102
1009893,30568,97455,22899,84461,235383
1009894,9887,34176,66828,57859,168750
1009895,38173,65086,50706,73407,227372
1009896,652,53356,46456,23889,124353
1009897,95207,85259,5575,88618,274659
1009898,41440,45254,50086,38881,175661
1009899,13228,71470,56384,92307,233389
1009900,68236,27744,1634,47509,145123
1009901,33767,68590,75099,47570,225026
1009902,27349,21356,91574,20583,160862
1009903,28726,83641,50663,83930,246960
1009904,25147,27888,88160,46923,188118
1009905,15240,95255,45529,71136,227160
1009906,65106,61071,7725,14604,148506
1009907,60402,60252,75573,42102,238329
1009908,31413,18068,62282,12457,124220
1009909,51021,86073,8243,4587,149924
1009910,57258,16463,39083,63327,176131
1009911,29307,29165,86408,18913,163793
1009912,74873,90819,85746,15081,266519
1009913,7733,58983,65108,8892,140716
1009914,49071,86696,61198,84338,281303
1009915,20991,41691,45954,12114,120750
1009916,81574,44064,98244,94469,318351
1009917,16329,94133,41001,43240,194703
1009918,2906,99,40071,89984,133060
1009919,72628,98227,712,30822,202389
1009920,82801,53047,58672,35907,230427
1009921,20693,3626,23342,84270,131931
1009922,52814,27640,31320,56606,168380
1009923,72993,59414,43953,39446,215806
1009924,40974,66503,69969,12802,190248
1009925,20413,64462,96500,14681,196056
1009926,13893,18621,51364,42421,126299
1009927,38580,28012,61910,85933,214435
1009928,4680,48904,32376,1540,87500
1009929,95328,54544,66130,89415,305417
1009930,68978,51947,56366,38362,215653
1009931,38702,65336,81805,73287,259130
1009932,92963,13721,14837,84634,206155
1009933,61480,47690,77856,5155,192181
1009934,6431,85906,8655,24113,125105
1009935,67217,46930,94225,17351,225723
1009936,58199,84934,64427,18765,226325
1009937,62841,34549,51522,13550,162462
1009938,50163,83957,87295,18478,239893
1009939,47412,45267,30402,86388,209469
1009940,14920,32846,64855,9596,122217
1009941,99478,61638,67782,23926,252824
1009942,72568,99617,77779,53237,303201
1009943,82598,49573,16106,77024,225301
1009944,54385,63590,78348,76974,273297
1009945,52632,90422,95091,75288,313433
1009946,1947,27020,30501,31980,91448
1009947,69750,52440,83875,84960,291025
1009948,10409,31623,80737,50659,173428
1009949,55866,51040,47568,99797,254271
1009950,33086,53581,38789,72052,197508
1009951,58320,28703,11891,99506,198420
1009952,89354,80619,44140,64940,279053
1009953,73260,74326,94293,39104,280983
1009954,92467,49358,35487,57787,235099
1009955,46737,76055,77303,4919,205014
1009956,10568,65037,25128,84782,185515
1009957,63570,93134,97877,78473,333054
1009958,53152,88880,15052,11106,168190
1009959,89849,97606,18528,35748,241731
1009960,54243,27605,37969,17959,137776
1009961,28789,47890,87873,35357,199909
1009962,50222,37871,99451,84249,271793
1009963,79387,4251,17368,62676,163682
1009964,31134,69497,29060,44845,174536
1009965,58045,82227,40486,13869,194627
1009966,80540,80313,50987,82382,294222
1009967,51170,29312,75182,91811,247475
1009968,98719,21095,49495,54481,223790
1009969,13810,163,50872,91809,156654
1009970,329,51347,74817,48485,174978
1009971,36992,86120,32961,21283,177356
1009972,95429,57159,23497,29686,205771
1009973,31873,86496,27886,59250,205505
1009974,65516,67605,19026,68212,220359
1009975,51099,98265,87379,71874,308617
1009976,22204,32365,29637,43364,127570
1009977,86146,10639,71481,30864,199130
1009978,10864,70384,51220,13663,146131
1009979,91257,46621,75447,98534,311859
1009980,37983,87371,39023,74385,238762
1009981,39222,18279,627,38418,96546
1009982,12142,52497,14107,84948,163694
1009983,52736,22769,31647,50185,157337
1009984,14516,42746,12531,83439,153232
1009985,29196,85422,99259,43575,257452
1009986,62448,49861,56900,35453,204662
1009987,63648,62862,87187,49905,263602
1009988,46625,86265,89034,49975,271899
1009989,59208,71023,61177,17642,209050
1009990,22863,68458,42041,3518,136880
1009991,77405,74359,84653,9239,245656
1009992,60243,8000,98499,39403,206145
1009993,3707,80299,37094,60467,181567
1009994,69244,11185,88543,68628,237600
1009995,68771,49200,3976,64948,186895
1009996,53878,73799,45678,71402,244757
1009997,37491,56021,80201,71656,245369
1009998,11489,40874,69061,83849,205273
1009999,94522,13731,75396,30794,214443
1010000,57793,88984,70682,31328,248787
1010001,23468,28213,76574,52955,181210
1010002,20101,2262,4582,89402,116347
1010003,68787,81261,22756,89326,262130
1010004,662,89019,84900,28897,203478
1010005,87471,64178,19356,28724,199729
1010006,54370,57318,65078,31144,207910
1010007,44546,71231,86609,17702,220088
1010008,85285,11891,4097,77755,179028
1010009,65427,37248,29195,86857,218727
1010010,28954,58572,19047,67615,174188
1010011,85203,50010,14806,52440,202459
1010012,61786,34870,55283,46794,198733
1010013,94420,44621,19131,10466,168638
1010014,92809,39017,69258,27914,228998
1010015,60226,78969,75058,84880,299133
1010016,61054,59335,11164,62068,193621
1010017,21076,95765,15090,8783,140714
1010018,91258,49276,88928,62092,291554
1010019,39201,22312,54139,37574,153226
1010020,24878,60912,71264,49025,206079
1010021,30264,80200,88741,3929,203134
1010022,44141,63264,91819,92925,292149
1010023,95204,78748,82256,71084,327292
1010024,79290,34289,39200,83755,236534
1010025,86083,10489,22121,8936,127629
1010026,89951,71620,54245,19849,235665
1010027,19157,49137,15710,91079,175083
1010028,43560,7469,75986,99717,226732
1010029,65331,61885,32369,30829,190414
1010030,9988,31731,60157,50152,152028
1010031,41907,66293,22401,98062,228663
1010032,53921,38005,19112,14164,125202
1010033,39008,492,85321,98877,223698
1010034,78952,93720,31820,1087,205579
1010035,3614,77999,75688,29164,186465
1010036,52705,32123,66161,67435,218424
1010037,63679,93600,82714,21693,261686
1010038,73289,69741,66842,97919,307791
1010039,7522,18953,94744,45361,166580
1010040,37145,88017,37123,88265,250550
1010041,76653,58048,23543,78533,236777
1010042,86866,45533,6891,91094,230384
1010043,38412,47271,43310,89256,218249
1010044,7198,18308,59783,75430,160719
1010045,73753,89867,10342,42606,216568
1010046,15059,7378,68132,21745,112314
1010047,81736,94203,27202,75510,278651
1010048,4706,543,70179,87657,163085
1010049,42450,78706,8399,68140,197695
1010050,80717,37699,54300,78562,251278
1010051,79731,45331,68788,39438,233288
1010052,66599,76380,33787,27612,204378
1010053,80324,63691,72525,15040,231580
1010054,65634,87282,62311,25368,240595
1010055,41000,94015,34390,74693,244098
1010056,60929,33442,98999,39714,233084
1010057,84697,72316,52412,61369,270794
1010058,43408,96892,22425,95183,257908
1010059,29502,39725,7304,25596,102127
1010060,25863,42222,91572,23026,182683
1010061,81062,7558,71397,88435,248452
1010062,32817,61194,77083,2316,173410
1010063,89973,74850,97640,25655,288118
1010064,56489,7744,3701,19945,87879
1010065,79034,80795,43585,83322,286736
1010066,60412,83780,38167,32795,215154
1010067,6436,17191,74659,96431,194717
1010068,68694,19709,87486,14662,190551
1010069,15780,73987,76200,28472,194439
1010070,63128,99001,49811,86306,298246
1010071,32699,50364,31956,6816,121835
1010072,90566,15051,34321,72132,212070
1010073,8929,42341,32518,55301,139089
1010074,85452,8309,44995,72074,210830
1010075,52380,90704,69658,51353,264095
1010076,48519,55024,31329,18874,153746
1010077,5951,87565,47350,4687,145553
1010078,59522,55045,20175,7450,142192
1010079,73851,25088,10725,31959,141623
1010080,74641,16287,64735,55278,210941
1010081,83035,68066,98983,76975,327059
1010082,77148,61950,89787,4124,233009
1010083,52309,24472,70584,57129,204494
1010084,26743,26844,39493,77547,170627
1010085,96307,91885,80543,37253,305988
1010086,51304,12632,19000,87556,170492
1010087,98909,25810,15793,73554,214066
1010088,77215,1309,95755,17016,191295
1010089,2353,41733,75381,15797,135264
1010090,7050,94091,11541,6221,118903
1010091,95488,86211,85502,99109,366310
1010092,6933,84169,25275,28879,145256
1010093,92711,80388,21015,68747,262861
1010094,78486,81239,3551,62126,225402
1010095,24518,40450,29513,45766,140247
1010096,86261,11954,43728,3823,145766
1010097,13301,52425,9422,39913,115061
1010098,86418,34029,15517,68366,204330
1010099,53634,91060,4129,75779,224602
1010100,90798,35355,75323,35259,236735
1010101,3206,5659,88355,47553,144773
1010102,71248,34044,58557,77,163926
1010103,1414,35276,29525,45706,111921
1010104,31841,27095,76511,50516,185963
1010105,70332,50715,20201,79465,220713
1010106,63266,71835,84377,60243,279721
1010107,12228,75216,58442,32239,178125
1010108,585,13479,490,35195,49749
1010109,1208,11592,42037,91583,146420
1010110,44800,12327,71588,5272,133987
1010111,1889,16957,50109,53687,122642
1010112,31876,20027,26556,90728,169187
1010113,28537,34327,30536,16127,109527
1010114,36437,79712,47948,87128,251225
1010115,36813,96507,20155,65957,219432
1010116,81828,45550,50876,29689,207943
1010117,90502,90858,89722,35608,306690
1010118,66036,47081,58541,11576,183234
1010119,51004,16227,21830,51781,140842
1010120,51057,66245,40759,37980,196041
1010121,32539,13859,88422,83944,218764
1010122,77607,16332,83442,65580,242961
1010123,63729,15797,69745,61422,210693
1010124,28489,89465,76779,60109,254842
1010125,79422,31918,67026,4861,183227
1010126,42784,25771,79877,89035,237467
1010127,11406,46417,44948,53631,156402
1010128,38421,45793,58579,93736,236529
1010129,45022,61460,88896,54192,249570
1010130,28219,36680,30146,93145,188190
1010131,28140,67244,89531,1796,186711
1010132,85743,27954,91383,16123,221203
1010133,17009,89545,34177,23832,164563
1010134,90140,51688,57273,57724,256825
1010135,15031,64919,10275,493,90718
1010136,51808,14031,54520,86014,206373
1010137,23484,602,84296,20100,128482
1010138,87547,15430,54530,83831,241338
1010139,7539,92901,42276,82573,225289
1010140,72403,79996,6473,7149,166021
1010141,43068,6034,63168,83450,195720
1010142,95377,97054,89927,86481,368839
1010143,61048,4607,97125,48894,211674
1010144,95963,33995,37817,29004,196779
1010145,7779,42021,32785,20620,103205
1010146,10677,44742,90824,38321,184564
1010147,12735,89773,67905,91463,261876
1010148,14269,84185,41057,64149,203660
1010149,5957,87971,69378,68506,231812
1010150,92329,74108,945,89630,257012
1010151,18360,83438,72948,56773,231519
1010152,66459,51290,99306,46100,263155
1010153,3671,9928,64584,51939,130122
1010154,51415,33837,83949,61366,230567
1010155,4876,92455,16295,42218,155844
1010156,88206,98208,79137,15514,281065
1010157,39586,23985,12498,35682,111751
1010158,52125,42933,39157,29470,163685
1010159,13251,18232,78147,64251,173881
1010160,58341,95827,6655,69057,229880
1010161,62707,98165,3887,34145,198904
1010162,36770,16951,96074,60638,210433
1010163,28732,86809,73245,26398,215184
1010164,51314,15184,84815,13938,165251
1010165,84070,42056,85083,99661,310870
1010166,37757,75837,65368,13396,192358
1010167,66075,19432,71092,73609,230208
1010168,40063,62937,86656,34209,223865
1010169,46180,36654,40250,67025,190109
1010170,23814,71069,78383,19210,192476
1010171,24878,42481,25136,70878,163373
1010172,32491,77932,90747,5564,206734
1010173,47455,55242,29628,48302,180627
1010174,92010,38194,28776,98331,257311
1010175,66346,8975,62745,44442,182508
1010176,25669,60053,39686,85543,210951
1010177,25984,18409,27983,92757,165133
1010178,42072,35923,49960,28589,156544
1010179,33918,34124,94764,92159,254965
1010180,28228,40998,63017,2383,134626
1010181,49491,57562,4219,6200,117472
1010182,38340,82068,57981,52355,230744
1010183,63768,76309,29834,8513,178424
1010184,10795,50038,1169,50442,112444
1010185,47208,12358,62475,68903,190944
1010186,19139,37335,95334,18796,170604
1010187,38924,26311,90509,28328,184072
1010188,85634,3483,66212,17660,172989
1010189,91402,51211,84818,9176,236607
1010190,1444,11339,14593,50676,78052
1010191,76712,69087,78267,66566,290632
1010192,71154,59391,85604,87479,303628
1010193,84704,42134,23548,41556,191942
1010194,61341,57212,33347,46507,198407
1010195,3034,92341,50465,43783,189623
1010196,19836,78328,20398,53236,171798
1010197,80937,83373,1433,3810,169553
1010198,79348,11600,48771,68842,208561
1010199,95540,17312,27769,62178,202799
1010200,1681,81837,12394,9006,104918
1010201,84117,88999,26687,36801,236604
1010202,86443,30185,759,23974,141361
1010203,3795,95344,5309,58055,162503
1010204,96678,34170,21218,22653,174719
1010205,68634,39375,45304,54486,207799
1010206,14366,20168,72361,61178,168073
1010207,54588,44581,56998,7382,163549
1010208,27146,66275,10050,19647,123118
1010209,61512,36514,83105,81921,263052
1010210,75694,23490,41103,86984,227271
1010211,82979,12848,13746,47254,156827
1010212,43499,50389,4326,28283,126497
1010213,7980,13468,51368,79554,152370
1010214,85306,91098,90466,63074,329944
1010215,6985,25063,47756,92546,172350
1010216,21276,20791,38063,72182,152312
1010217,84613,29021,80651,92220,286505
1010218,45331,49047,564,18930,113872
1010219,51001,2349,32190,50115,135655
1010220,99128,54054,16373,59634,229189
1010221,4851,30015,42668,82017,159551
1010222,24465,97106,68602,80360,270533
1010223,38455,8082,65302,17358,129197
1010224,35467,48388,19515,88908,192278
1010225,90476,15266,86948,74144,266834
1010226,52526,77228,27448,79758,236960
1010227,62280,47366,83364,51276,244286
1010228,39286,86297,41430,97295,264308
1010229,10346,53913,9140,83613,157012
1010230,9405,56352,6631,17468,89856
1010231,26341,35371,16930,14898,93540
1010232,76662,41490,79635,13550,211337
1010233,87283,54625,39661,49250,230819
1010234,17491,62356,25670,38386,143903
1010235,65950,75,8440,22112,96577
1010236,73171,28231,83464,20,184886
1010237,3543,29532,64406,90532,188013
1010238,97100,57442,39068,26633,220243
1010239,37175,21910,21309,5192,85586
1010240,39665,97430,6561,18305,161961
1010241,92062,918,25773,41059,159812
1010242,44850,11838,81123,31204,169015
1010243,67397,18164,12948,1033,99542
1010244,61573,24800,63379,16376,166128
1010245,78005,34250,10495,20496,143246
1010246,1703,84091,98174,47315,231283
1010247,32424,14766,36798,35589,119577
1010248,81804,76210,80175,80993,319182
1010249,11292,83629,76603,7474,178998
1010250,86848,75732,83240,52258,298078
1010251,11485,66082,74886,57712,210165
1010252,98406,95327,41735,1503,236971
1010253,46641,53043,29843,55327,184854
1010254,33718,47381,4655,16941,102695
1010255,88555,29116,77206,11580,206457
1010256,45936,23472,97600,96938,263946
1010257,72323,77488,66348,86819,302978
1010258,95329,23818,3246,14207,136600
1010259,86913,48981,12277,25762,173933
1010260,43804,77911,58211,22522,202448
1010261,368,77409,20657,53135,151569
1010262,43673,26029,88002,9206,166910
1010263,75838,51015,64679,52922,244454
1010264,44252,16039,66339,88804,215434
1010265,27707,7488,54914,9883,99992
1010266,29933,11788,32526,43628,117875
1010267,11406,33589,59650,52547,157192
1010268,58197,39142,48178,44824,190341
1010269,97751,77748,17245,94798,287542
1010270,4806,94097,4998,101,104002
1010271,50764,86177,41886,98180,277007
1010272,80920,80891,9400,44931,216142
1010273,44236,2478,77880,28368,152962
1010274,65766,71800,2008,16347,155921
1010275,35945,85866,9167,83169,214147
1010276,65030,46453,11115,43335,165933
1010277,496,10038,96410,20659,127603
1010278,42358,40617,96446,6565,185986
1010279,14966,54995,80959,71638,222558
1010280,31422,6342,47727,93380,178871
1010281,37591,31081,65050,95237,228959
1010282,36205,8508,33844,56447,135004
1010283,25784,20641,3142,35357,84924
1010284,97451,23538,23491,79410,223890
1010285,2052,8699,68661,89762,169174
1010286,5111,7847,61841,72645,147444
1010287,83881,10933,32482,20073,147369
1010288,75485,28861,19596,94843,218785
1010289,42397,85535,51813,4009,183754
1010290,70857,82419,53631,14098,221005
1010291,45583,63736,32619,76265,218203
1010292,16592,92134,7065,34344,150135
1010293,27774,7233,91201,91922,218130
1010294,17662,46787,69404,44083,177936
1010295,88445,91142,47595,65293,292475
1010296,71438,73034,36162,51076,231710
1010297,86364,19586,81624,12041,199615
1010298,32630,72344,32917,31285,169176
1010299,22262,51690,67724,78531,220207
1010300,16018,28370,45515,9991,99894
1010301,92608,26725,63922,40902,224157
1010302,9989,27050,10340,56179,103558
1010303,44222,27898,65705,75104,212929
1010304,29733,74522,57992,43886,206133
1010305,63212,17711,31473,28389,140785
1010306,60487,61444,46030,5721,173682
1010307,5823,52900,40411,55198,154332
1010308,21995,72192,72572,86317,253076
1010309,58934,6791,91759,38150,195634
1010310,20501,1561,29168,51725,102955
1010311,7835,92917,70266,27708,198726
1010312,96840,72893,99857,32813,302403
1010313,27699,56952,79956,92545,257152
1010314,19133,27494,29421,67882,143930
1010315,18920,60797,79600,95181,254498
1010316,39939,61983,49700,53692,205314
1010317,62553,52693,58910,94135,268291
1010318,95225,25180,40968,76398,237771
1010319,34924,39744,63428,75861,213957
1010320,71733,85997,1377,60763,219870
1010321,22154,3259,31890,80352,137655
1010322,47376,148,63618,44044,155186
1010323,93139,15252,13563,85008,206962
1010324,70439,87108,57843,99007,314397
1010325,8589,45074,6160,99629,159452
1010326,31835,68833,23938,22612,147218
1010327,5519,87027,524,25496,118566
1010328,49192,88660,59351,61835,259038
1010329,89499,94773,23303,74329,281904
1010330,58757,84452,12924,52450,208583
1010331,23510,4414,41034,88866,157824
1010332,77590,83258,37453,3112,201413
1010333,69489,31018,43412,30182,174101
1010334,76675,1567,78285,49029,205556
1010335,83005,87247,235,71588,242075
1010336,52196,83161,61280,77312,273949
1010337,30286,39041,35711,21655,126693
1010338,92352,87659,88473,82836,351320
1010339,86789,92845,97953,11178,288765
1010340,40625,5929,11062,87964,145580
1010341,4370,56714,2301,11916,75301
1010342,60428,70242,56583,67601,254854
1010343,91986,28123,13110,39158,172377
1010344,21362,76300,85625,71729,255016
1010345,20453,90727,86795,69417,267392
1010346,32456,81952,55285,9596,179289
1010347,44992,32644,50392,48374,176402
1010348,2781,87376,72873,26627,189657
1010349,13623,53951,63564,30316,161454
1010350,53153,54475,6547,67986,182161
1010351,65978,73649,77563,51832,269022
1010352,82892,18884,36825,53491,192092
1010353,78033,65069,39239,49405,231746
1010354,41334,48640,83724,35330,209028
1010355,54935,30428,87752,31573,204688
1010356,53963,53279,76812,86261,270315
1010357,80408,47417,94800,86929,309554
1010358,362,38509,39780,29278,107929
1010359,73331,41547,67133,77401,259412
1010360,28536,83743,11491,8657,132427
1010361,59688,82738,86244,74578,303248
1010362,83243,42029,57707,25235,208214
1010363,84353,80115,27429,79431,271328
1010364,49475,41094,77764,96044,264377
1010365,80557,41737,88188,37035,247517
1010366,27526,1385,9305,48655,86871
1010367,83147,77771,89721,70475,321114
1010368,59952,7262,9549,73258,150021
1010369,95716,62076,60818,42949,261559
1010370,62495,1475,98970,61013,223953
1010371,56426,15588,81793,67239,221046
1010372,7623,11901,31728,61020,112272
1010373,4292,97591,79598,3123,184604
1010374,12692,63285,96936,56027,228940
1010375,94139,67196,73928,24850,260113
1010376,12145,73224,12817,45276,143462
1010377,85315,13125,51300,74873,224613
1010378,95999,55368,74649,53368,279384
1010379,95992,62799,74451,67774,301016
1010380,44805,51490,32480,576,129351
1010381,30861,34745,73866,19701,159173
1010382,81415,5494,30482,73139,190530
1010383,47979,6712,77594,75751,208036
1010384,22137,71424,60062,16192,169815
1010385,78285,9688,66694,50052,204719
1010386,86927,7131,80151,90922,265131
1010387,13489,76441,3022,21701,114653
1010388,75630,34636,67351,68030,245647
1010389,49424,24188,56506,45669,175787
1010390,32884,38879,93238,67196,232197
1010391,82783,67719,74197,33464,258163
1010392,56473,84464,82297,87315,310549
1010393,52647,9144,67691,72949,202431
1010394,48470,60175,83079,10251,201975
1010395,8511,90267,37420,30013,166211
1010396,40718,58727,86778,33206,219429
1010397,96330,19138,66608,97296,279372
1010398,28710,49209,10832,47559,136310
1010399,50224,75903,1758,26004,153889
1010400,59051,89806,13637,65452,227946
1010401,39938,61860,155,59027,160980
1010402,31910,37269,4589,362,74130
1010403,39206,712,67986,97781,205685
1010404,41357,57609,77148,72249,248363
1010405,32434,23760,84585,56343,197122
1010406,46797,51443,44177,87555,229972
1010407,69788,32915,65975,88095,256773
1010408,36375,60656,49498,92013,238542
1010409,35555,71333,7494,56454,170836
1010410,64866,15493,44699,27649,152707
1010411,92660,12111,23105,57961,185837
1010412,66223,70383,90832,15785,243223
1010413,3338,36726,49444,8520,98028
1010414,58616,16431,84119,49936,209102
1010415,7277,32566,73257,78190,191290
1010416,99019,96544,57120,6805,259488
1010417,97695,56704,68035,15199,237633
1010418,75660,8121,49379,56131,189291
1010419,56081,94799,56321,72188,279389
1010420,87396,62000,55670,47279,252345
1010421,29721,78788,56124,38956,203589
1010422,2744,23136,20380,53178,99438
1010423,41059,57667,72653,18236,189615
1010424,55403,92118,5420,45201,198142
1010425,97512,65604,87555,63369,314040
1010426,9407,22117,11108,53008,95640
1010427,3179,16064,85415,48506,153164
1010428,63116,25105,81133,56136,225490
1010429,96678,8639,18023,45183,168523
1010430,15356,39776,65009,60268,180409
1010431,90572,66143,72811,4872,234398
1010432,23097,72716,36283,42966,175062
1010433,62472,69691,52423,72441,257027
1010434,58652,48204,67409,11172,185437
1010435,74087,54172,6193,98008,232460
1010436,27885,40673,55295,11705,135558
1010437,72638,48861,76935,93221,291655
1010438,30277,2987,84477,15952,133693
1010439,78133,93570,44976,43787,260466
1010440,69711,60417,87557,58876,276561
1010441,39296,24173,15380,99037,177886
1010442,14582,12917,16721,37547,81767
1010443,10767,69557,84746,38993,204063
1010444,11128,93698,18346,69766,192938
1010445,66479,40531,68006,56915,231931
1010446,88785,55956,38541,74440,257722
1010447,904,32417,89830,74890,198041
1010448,9800,8488,13078,99350,130716
1010449,48180,7101,45511,7594,108386
1010450,42618,10495,22717,23588,99418
1010451,92461,91370,30933,6879,221643
1010452,72592,29811,78633,21157,202193
1010453,11820,69918,5536,6393,93667
1010454,64527,55524,29016,73399,222466
1010455,45879,89028,97815,19166,251888
1010456,39984,17436,59676,34837,151933
1010457,88209,51054,26285,72821,238369
1010458,11391,22296,67611,60369,161667
1010459,44840,57708,3483,77963,183994
1010460,17372,66066,27124,4849,115411
1010461,48213,89239,34557,16602,188611
1010462,32511,17713,19181,78279,147684
1010463,22593,47284,59515,23219,152611
1010464,89270,55232,40606,12655,197763
1010465,72318,42364,98465,92859,306006
1010466,17873,32845,12286,5324,68328
1010467,98073,69811,81801,58250,307935
1010468,97062,12288,99762,83812,292924
1010469,40240,33679,55813,22105,151837
1010470,7133,67508,65906,42877,183424
1010471,70261,84742,92535,51922,299460
1010472,12247,89836,22924,83588,208595
1010473,73958,66783,17151,28402,186294
1010474,87079,43727,69513,81318,281637
1010475,13110,84968,23112,51732,172922
1010476,55557,3317,66569,62053,187496
1010477,76559,18543,65723,66024,226849
1010478,58484,94252,88012,18186,258934
1010479,18634,79313,35729,75317,208993
1010480,90413,98929,71130,76753,337225
1010481,55272,84084,98840,99605,337801
1010482,76578,52403,10415,90210,229606
1010483,84833,68035,2855,10927,166650
1010484,7827,58999,24321,17868,109015
1010485,40654,12323,71414,37986,162377
1010486,57845,83401,3224,15341,159811
1010487,23171,35589,84319,11614,154693
1010488,62232,80339,72022,78493,293086
1010489,49218,77354,13995,74606,215173
1010490,4618,9846,16919,74520,105903
1010491,51696,49937,26728,8717,137078
1010492,38188,23984,49923,6390,118485
1010493,66537,99359,28190,38103,232189
1010494,38831,15160,8599,80236,142826
1010495,58353,62570,25474,67679,214076
1010496,24009,54245,53712,8413,140379
1010497,97499,57159,99161,23279,277098
1010498,27311,75336,32098,25500,160245
1010499,43449,30046,79326,16750,169571
1010500,65658,69248,48258,40482,223646
1010501,83429,35419,27060,31056,176964
1010502,76023,63810,82840,69705,292378
1010503,37180,67790,66898,67850,239718
1010504,41701,19980,6467,68060,136208
1010505,48046,72723,71529,68570,260868
1010506,86582,98234,52561,37596,274973
1010507,86552,54115,80069,9161,229897
1010508,27714,87064,23481,16908,155167
1010509,23248,78768,31355,72020,205391
1010510,32525,85085,52618,13537,183765
1010511,67564,82792,32259,81074,263689
1010512,7249,56307,58404,59920,181880
1010513,93333,49890,48248,20351,211822
1010514,60661,91614,28272,93164,273711
1010515,70946,6462,85508,16037,178953
1010516,78437,20148,41032,56285,195902
1010517,16464,21423,84500,67859,190246
1010518,69264,88976,59543,27469,245252
1010519,12842,55751,6713,38052,113358
1010520,46107,62381,31641,57454,197583
1010521,84658,40223,62941,37229,225051
1010522,17989,10307,14877,96007,139180
1010523,25759,39225,16653,50284,131921
1010524,1387,20496,96250,30612,148745
1010525,25508,28485,84395,99490,237878
1010526,32361,33662,43744,63779,173546
1010527,20360,79002,37141,15837,152340
1010528,93,23286,38339,31422,93140
1010529,17774,20967,47794,85699,172234
1010530,76557,45920,31257,34781,188515
1010531,54129,50987,18698,31502,155316
1010532,31098,53372,41627,26271,152368
1010533,72448,35207,89179,77412,274246
1010534,37732,13258,11414,55345,117749
1010535,17085,57377,48089,90633,213184
1010536,65554,98711,52018,46842,263125
1010537,54811,21474,29188,37674,143147
1010538,61349,96169,47745,96328,301591
1010539,59382,15313,21567,24180,120442
1010540,80418,52145,76356,73574,282493
1010541,87459,43333,15874,26175,172841
1010542,46059,433,28118,82963,157573
1010543,94630,86640,37685,75144,294099
1010544,86374,64459,61100,38004,249937
1010545,89052,48647,10225,18180,166104
1010546,93714,97911,94386,4896,290907
1010547,53028,70538,82153,35036,240755
1010548,14447,68478,66928,56072,205925
1010549,40319,86464,51535,40080,218398
1010550,33577,15000,68224,27333,144134
1010551,54452,35711,97779,54018,241960
1010552,91319,62590,95729,76674,326312
1010553,43173,66044,52713,13042,174972
1010554,21322,70998,78512,70575,241407
1010555,49969,12419,97310,93392,253090
1010556,56176,90961,78050,28270,253457
1010557,98390,60873,26792,84122,270177
1010558,52557,83855,38659,77443,252514
1010559,36451,36349,68617,68308,209725
1010560,81349,28097,40027,70864,220337
1010561,41829,13332,55508,9716,120385
1010562,21550,76978,25748,1270,125546
1010563,73797,81591,91857,94479,341724
1010564,85365,1339,65842,97031,249577
1010565,60230,84419,43753,349,188751
1010566,87201,53396,57583,52204,250384
1010567,45057,96583,88953,97641,328234
1010568,26436,67279,20109,76825,190649
1010569,77007,79673,12338,37783,206801
1010570,33278,27061,83159,15289,158787
1010571,46762,25745,86881,81633,241021
1010572,89316,75610,93800,44452,303178
1010573,4585,52302,87017,20816,164720
1010574,76882,53113,92787,85565,308347
1010575,70509,67728,44591,66647,249475
1010576,95403,35514,2228,64192,197337
1010577,78765,28192,64121,10830,181908
1010578,71471,34006,69477,51950,226904
1010579,23136,99502,5216,32558,160412
1010580,63755,90290,14074,63608,231727
1010581,18524,57553,10776,53590,140443
1010582,28756,66707,35117,50317,180897
1010583,87137,29908,99757,24765,241567
1010584,89654,49570,83947,86672,309843
1010585,19453,21215,66344,28128,135140
1010586,5972,45388,7961,60389,119710
1010587,56083,93526,22434,79390,251433
1010588,97762,86145,36249,67069,287225
1010589,88930,12655,68000,15950,185535
1010590,55921,48788,29042,41587,175338
1010591,56433,17378,8116,23806,105733
1010592,44131,7816,89182,90915,232044
1010593,34761,67824,64743,70064,237392
1010594,71269,72489,72840,11152,227750
1010595,76438,49786,46160,14591,186975
1010596,23764,38069,48148,31088,141069
1010597,73769,39147,80040,95904,288860
1010598,70681,40772,79389,45348,236190
1010599,76362,31715,62813,15863,186753
1010600,15871,45471,88982,88740,239064
1010601,71552,29454,32160,96429,229595
1010602,51389,44993,70557,73619,240558
1010603,19189,65955,51691,42797,179632
1010604,60763,75273,76278,89362,301676
1010605,51851,63641,89773,15799,221064
1010606,81064,60425,67371,62936,271796
1010607,78920,62754,87016,358,229048
1010608,66250,75723,22663,9863,174499
1010609,83310,19287,23167,52720,178484
1010610,28317,74789,79426,47036,229568
1010611,38446,20284,47301,10910,116941
1010612,60200,21039,82444,37141,200824
1010613,97027,54301,50936,88714,290978
1010614,23852,38641,19649,68165,150307
1010615,61700,79166,38724,44942,224532
1010616,83722,72148,17632,92256,265758
1010617,88162,17751,36797,8553,151263
1010618,95316,7521,4530,19959,127326
1010619,74743,78098,83339,83333,319513
1010620,32348,84861,29569,75744,222522
1010621,82312,79517,42360,67822,272011
1010622,20616,8939,23103,27457,80115
1010623,26482,61102,3199,18590,109373
1010624,43437,13906,96617,1060,155020
1010625,99684,56313,64463,80965,301425
1010626,68491,60434,18823,24653,172401
1010627,96705,8729,40768,72398,218600
1010628,64478,67909,12012,33424,177823
1010629,92616,14598,18168,32145,157527
1010630,79310,20245,39377,90763,229695
1010631,80629,63518,50466,57414,252027
1010632,34740,72344,85281,76184,268549
1010633,52049,19993,41290,23420,136752
1010634,84371,58992,66055,31360,240778
1010635,45455,22755,99565,86797,254572
1010636,58301,86101,22870,27948,195220
1010637,78300,28871,57957,64454,229582
1010638,78872,55003,54488,75326,263689
1010639,89390,95981,72911,41922,300204
1010640,94541,60994,68279,75856,299670
1010641,32096,25043,32998,96240,186377
1010642,80447,59626,13038,94477,247588
1010643,34727,81310,51965,51024,219026
1010644,31597,16700,2887,10784,61968
1010645,7554,14293,33689,71860,127396
1010646,2117,80174,67953,36817,187061
1010647,42724,53391,22319,96087,214521
1010648,90975,53152,14813,26074,185014
1010649,38616,68140,77666,16378,200800
1010650,24496,76259,18606,40777,160138
1010651,28166,61567,81257,42900,213890
1010652,52457,54633,70117,64387,241594
1010653,54628,16685,78393,75417,225123
1010654,19059,48300,44064,13990,125413
1010655,95241,24378,3598,14012,137229
1010656,41191,15640,85636,49500,191967
1010657,63766,59549,18340,91977,233632
1010658,79092,51145,53958,36602,220797
1010659,50095,7629,15106,16185,89015
1010660,22882,31934,97616,41818,194250
1010661,99376,56995,48109,91114,295594
1010662,47869,82819,426,89824,220938
1010663,93393,14863,73460,98149,279865
1010664,56661,58337,18965,59836,193799
1010665,18877,43843,74612,75367,212699
1010666,47556,51099,97142,97351,293148
1010667,49290,38151,20494,96264,204199
1010668,59954,2166,22068,49905,134093
1010669,40172,6672,8560,95394,150798
1010670,6458,54500,12630,89804,163392
1010671,17261,15192,97884,61340,191677
1010672,77192,92004,20057,40893,230146
1010673,74033,7867,63143,53354,198397
1010674,18007,79718,66881,35162,199768
1010675,95,78246,84957,56665,219963
1010676,98313,53278,89434,62403,303428
1010677,15789,11064,16861,59638,103352
1010678,22345,75301,92052,59162,248860
1010679,12455,61830,55296,67783,197364
1010680,49196,34867,53012,39345,176420
1010681,46773,78259,17607,97080,239719
1010682,17444,19020,31193,80279,147936
1010683,4579,28039,92680,42077,167375
1010684,55210,98226,71556,88678,313670
1010685,2318,93055,17712,10126,123211
1010686,21536,38100,96482,25649,181767
1010687,80642,49659,27281,32387,189969
1010688,26802,64020,80304,9000,180126
1010689,76541,81956,44682,20300,223479
1010690,30711,60600,33292,63882,188485
1010691,80735,31555,1492,55783,169565
1010692,16367,79125,52972,3317,151781
1010693,71475,79786,97632,62154,311047
1010694,84665,32350,80233,15037,212285
1010695,1254,57976,43866,98199,201295
1010696,7342,99112,19498,30762,156714
1010697,5366,76930,85141,88629,256066
1010698,54593,57461,64702,5627,182383
1010699,27924,62323,93053,67877,251177
1010700,90971,76389,5655,58826,231841
1010701,93378,31710,8230,40463,173781
1010702,59785,21007,91406,8986,181184
1010703,99759,47462,81001,14350,242572
1010704,52238,82323,21469,15270,171300
1010705,62523,13091,10599,27244,113457
1010706,92684,53882,13560,12866,172992
1010707,8337,42310,72512,90002,213161
1010708,18016,20445,38940,74154,151555
1010709,64072,50140,99725,83934,297871
1010710,34144,81731,77521,1880,195276
1010711,43496,39489,60548,83731,227264
1010712,34927,60464,8520,66274,170185
1010713,37509,26797,16168,10226,90700
1010714,50824,21011,29644,20278,121757
1010715,62332,11216,16349,35392,125289
1010716,88037,22697,3619,46735,161088
1010717,5396,34448,56526,52630,149000
1010718,34306,84172,91117,57351,266946
1010719,55732,50431,73925,75224,255312
1010720,43412,65744,6890,15971,132017
1010721,56713,73916,44159,45972,220760
1010722,29739,11764,58346,29878,129727
1010723,69469,857,70515,16869,157710
1010724,89422,66761,38410,66669,261262
1010725,78651,22351,51026,92116,244144
1010726,94209,87002,80935,17708,279854
1010727,10834,95969,8670,44442,159915
1010728,31897,16738,25456,29905,103996
1010729,89701,89362,74967,53977,308007
1010730,81877,20617,23836,22553,148883
1010731,83450,64450,73518,51394,272812
1010732,86339,19203,67287,16974,189803
1010733,2540,43484,65092,43303,154419
1010734,76545,95481,91726,42059,305811
1010735,48961,88367,53164,3011,193503
1010736,87469,66148,49108,52920,255645
1010737,6327,71209,2215,31460,111211
1010738,62983,59703,14095,36260,173041
1010739,88031,5794,41420,18451,153696
1010740,10527,48705,44433,28062,131727
1010741,43391,35115,81429,28003,187938
1010742,50432,98722,69619,79999,298772
1010743,25938,84820,39042,21082,170882
1010744,6298,95707,17839,17012,136856
1010745,79197,38750,53728,87088,258763
1010746,94808,92908,60274,9355,257345
1010747,62327,71885,90880,39013,264105
1010748,47105,51139,65240,56253,219737
1010749,1972,93437,71316,28482,195207
1010750,99583,19229,74514,18414,211740
1010751,82839,70082,81664,70587,305172
1010752,45577,21519,21821,14115,103032
1010753,49610,89884,5772,14872,160138
1010754,92982,99184,92311,99725,384202
1010755,96354,53341,833,23317,173845
1010756,47122,43631,17775,26467,134995
1010757,95347,7235,73555,13768,189905
1010758,10435,28629,73106,67325,179495
1010759,77841,79821,71808,40190,269660
1010760,59322,40296,11956,45021,156595
1010761,23475,15453,12821,11486,63235
1010762,60981,96084,14053,7555,178673
1010763,49670,85953,72017,25438,233078
1010764,97442,4905,69979,16944,189270
1010765,1963,94519,5643,40307,142432
1010766,76844,25145,8471,39350,149810
1010767,53350,2872,39433,41505,137160
1010768,5412,78396,73633,28317,185758
1010769,25844,9757,8397,19102,63100
1010770,88298,17949,12071,63937,182255
1010771,11483,12505,72197,69496,165681
1010772,21287,7524,75275,53090,157176
1010773,26236,66724,10731,84077,187768
1010774,52193,61595,31086,62309,207183
1010775,4040,36988,7028,62085,110141
1010776,3228,28398,24639,87740,144005
1010777,34885,95101,51563,44997,226546
1010778,92993,32526,38930,49739,214188
1010779,57104,29716,60030,76464,223314
1010780,47061,31026,1189,1838,81114
1010781,13743,1469,10968,7171,33351
1010782,30711,88868,13010,83244,215833
1010783,97553,89280,304,5934,193071
1010784,9216,63686,52,36058,109012
1010785,2785,88007,68047,92932,251771
1010786,11192,75330,57738,49775,194035
1010787,28457,80564,14450,43446,166917
1010788,75500,61674,91546,10481,239201
1010789,92430,81557,5676,3464,183127
1010790,29129,14957,4138,66022,114246
1010791,81931,58117,15965,15488,171501
1010792,56834,52989,9922,25290,145035
1010793,92766,89675,73832,84904,341177
1010794,46541,5423,36047,14936,102947
1010795,76255,34112,35055,75116,220538
1010796,33150,8738,94018,91339,227245
1010797,43057,72590,33051,77127,225825
1010798,56041,54144,34450,36360,180995
1010799,1349,56191,9539,22409,89488
1010800,84259,75402,85411,11635,256707
1010801,49699,92400,66865,30698,239662
1010802,30209,16585,5907,43608,96309
1010803,52400,16569,24851,36632,130452
1010804,81558,10232,22750,801,115341
1010805,45053,21554,56468,15293,138368
1010806,72832,91425,76704,42484,283445
1010807,80611,24339,69366,33646,207962
1010808,81628,27519,16205,50789,176141
1010809,77769,98479,9565,31632,217445
1010810,11480,24659,85633,16502,138274
1010811,61268,65372,48837,75614,251091
1010812,16131,53703,91242,19634,180710
1010813,3861,5859,81016,42149,132885
1010814,3698,80433,79431,64064,227626
1010815,38338,62705,32327,84683,218053
1010816,40013,57315,91087,76179,264594
1010817,70648,87676,19199,83327,260850
1010818,74491,61358,95484,7872,239205
1010819,76050,64417,27998,87461,255926
1010820,82350,76306,38664,66057,263377
1010821,25789,18735,88536,60713,193773
1010822,88175,22410,71772,54170,236527
1010823,56565,73691,44459,87619,262334
1010824,49044,67682,18261,82499,217486
1010825,64200,62434,33562,12011,172207
1010826,2225,2327,41143,18948,64643
1010827,56008,56363,63151,79692,255214
1010828,41676,18019,44316,18495,122506
1010829,89732,53442,2579,21355,167108
1010830,97795,39885,77919,40362,255961
1010831,35694,47816,3278,51412,138200
1010832,73852,61465,92854,14193,242364
1010833,44101,18871,76625,59656,199253
1010834,64936,22842,33054,8647,129479
1010835,90901,93839,91310,18730,294780
1010836,44535,55984,95719,52691,248929
1010837,34584,13859,15098,60573,124114
1010838,10739,41330,72293,90760,215122
1010839,28065,66692,52643,76687,224087
1010840,63098,58746,71670,96257,289771
1010841,88504,82430,13554,61008,245496
1010842,14515,84002,50301,84007,232825
1010843,15099,98548,77505,92414,283566
1010844,20587,71081,60939,66758,219365
1010845,39760,94415,49714,31585,215474
1010846,40924,14982,80062,13304,149272
1010847,64230,80009,23226,19454,186919
1010848,942,58230,13591,62117,134880
1010849,85076,8297,28880,40119,162372
1010850,42423,88435,35877,53443,220178
1010851,98120,96230,65044,59862,319256
1010852,18416,8945,63313,53938,144612
1010853,97215,35599,91335,18755,242904
1010854,46929,21976,55998,7918,132821
1010855,15791,89974,51832,15693,173290
1010856,32030,89979,40629,8228,170866
1010857,94731,15004,42030,45581,197346
1010858,76216,43773,32552,60647,213188
1010859,23117,2755,66517,75261,167650
1010860,33395,35738,76688,77204,223025
1010861,89803,58504,12351,1137,161795
1010862,91510,89111,3561,1031,185213
1010863,13300,66952,94992,8054,183298
1010864,10335,65148,56062,67561,199106
1010865,79806,18251,44524,25266,167847
1010866,47687,61186,77341,22272,208486
1010867,2723,59102,11879,93455,167159
1010868,61982,57998,47705,98705,266390
1010869,62798,93891,93373,97970,348032
1010870,72090,48970,21507,47617,190184
1010871,74819,56462,53284,87677,272242
1010872,98748,87440,24576,10540,221304
1010873,70920,81866,6727,69932,229445
1010874,66759,43526,58749,11626,180660
1010875,61503,1318,1777,55543,120141
1010876,39818,32784,39637,3131,115370
1010877,64106,56157,28578,3245,152086
1010878,59785,41026,8979,7822,117612
1010879,98162,62821,9356,57918,228257
1010880,26805,61546,17446,68209,174006
1010881,2799,28995,41216,19701,92711
1010882,89919,45193,55960,90304,281376
1010883,40271,84538,33659,72746,231214
1010884,13573,95778,46650,98950,254951
1010885,50940,64203,64955,55047,235145
1010886,55995,4524,97273,95626,253418
1010887,35823,5679,51751,22946,116199
1010888,30832,65230,5315,83669,185046
1010889,92854,64969,56636,14324,228783
1010890,5898,10478,77022,52819,146217
1010891,93713,38578,94302,72527,299120
1010892,24197,55155,24235,1833,105420
1010893,80364,48345,74244,88016,290969
1010894,48906,25833,41727,32509,148975
1010895,76735,8310,76770,97447,259262
1010896,55237,84627,53721,3135,196720
1010897,65269,15213,42595,43191,166268
1010898,75883,84871,54138,52639,267531
1010899,35881,41532,47686,31270,156369
1010900,13571,64798,9512,60109,147990
1010901,83325,60418,49875,33786,227404
1010902,61591,14091,26834,49598,152114
1010903,77247,89070,4520,85741,256578
1010904,43881,80026,9571,46423,179901
1010905,36785,83596,72392,23258,216031
1010906,50546,85899,16290,7277,160012
1010907,50193,14480,20397,2290,87360
1010908,26455,10565,77301,71970,186291
1010909,71605,25577,77649,43522,218353
1010910,87004,62019,30315,30810,210148
1010911,95484,29990,54659,35006,215139
1010912,79964,41196,44231,65050,230441
1010913,76141,24700,40525,95106,236472
1010914,11278,14666,94832,17989,138765
1010915,55870,64457,56026,96754,273107
1010916,91524,56754,70438,87643,306359
1010917,90964,295,55369,94943,241571
1010918,67815,51314,86813,64037,269979
1010919,96481,83569,29049,48650,257749
1010920,49591,90944,8371,89906,238812
1010921,99725,60815,36656,15009,212205
1010922,14252,38446,20067,9367,82132
1010923,29295,2158,30980,39086,101519
1010924,39466,86769,1153,76240,203628
1010925,2485,70953,4392,72099,149929
1010926,88117,80001,83009,83646,334773
1010927,48124,95180,34615,72051,249970
1010928,12660,16395,17131,25768,71954
1010929,97923,79391,55007,76535,308856
1010930,22110,44652,74539,20719,162020
1010931,54318,62742,15997,75456,208513
1010932,61355,38494,21494,63248,184591
1010933,84065,42556,14333,12636,153590
1010934,84037,27430,61684,20615,193766
1010935,52166,30154,65046,16517,163883
1010936,29429,52600,65073,91908,239010
1010937,21340,55534,61799,51405,190078
1010938,55916,43537,4696,97899,202048
1010939,92097,75163,95939,90365,353564
1010940,11532,71919,17745,4017,105213
1010941,53798,79638,42208,51709,227353
1010942,6538,96987,34659,82349,220533
1010943,69172,9187,9165,71500,159024
1010944,67143,68129,66920,44577,246769
1010945,95818,3895,51317,32284,183314
1010946,89760,63997,79453,50013,283223
1010947,92955,10475,14455,20610,138495
1010948,92404,24541,51300,78743,246988
1010949,83770,97368,37462,81597,300197
1010950,63513,26159,71683,5145,166500
1010951,25438,36748,6944,72995,142125
1010952,86469,28378,92009,21816,228672
1010953,10843,58814,36238,62595,168490
1010954,10266,53412,53277,70809,187764
1010955,96871,48180,99446,13199,257696
1010956,43130,9852,28185,96439,177606
1010957,200,7603,64323,91186,163312
1010958,65741,52031,96759,75167,289698
1010959,39733,70008,35705,35580,181026
1010960,9735,88583,92046,11843,202207
1010961,3831,22223,97872,66704,190630
1010962,10436,45875,83976,3674,143961
1010963,63703,79689,41023,5522,189937
1010964,58499,1149,68138,2179,129965
1010965,84226,46424,29335,63963,223948
1010966,62183,35032,87286,14138,198639
1010967,20637,21932,20795,27340,90704
1010968,17861,55134,65814,20947,159756
1010969,87095,94845,55560,74325,311825
1010970,42297,63374,97321,47201,250193
1010971,9157,99044,40421,75374,223996
1010972,36544,5297,4955,66111,112907
1010973,41380,38959,96826,48442,225607
1010974,60846,54279,62385,25493,203003
1010975,49174,48309,29536,35465,162484
1010976,50778,87441,78395,7618,224232
1010977,9323,80618,58445,38245,186631
1010978,1758,94680,79027,55703,231168
1010979,82642,95461,72295,7868,258266
1010980,70540,43190,99439,95341,308510
1010981,23867,96436,23812,99088,243203
1010982,716,61501,16373,30993,109583
1010983,60966,69277,35068,8816,174127
1010984,72387,76728,61502,8856,219473
1010985,54138,44883,91586,93257,283864
1010986,95729,96301,37455,28842,258327
1010987,39661,78248,86982,8585,213476
1010988,548,57372,89733,32780,180433
1010989,59000,55472,75779,80632,270883
1010990,40006,15710,3620,59475,118811
1010991,2170,69173,32066,37721,141130
1010992,38454,62514,54799,28285,184052
1010993,44028,25028,14905,77733,161694
1010994,72275,30520,86915,49285,238995
1010995,58093,92090,69141,26005,245329
1010996,95724,78222,70796,49266,294008
1010997,59244,44500,11023,64525,179292
1010998,98609,23963,44814,33020,200406
1010999,43498,92032,70289,52728,258547
1011000,27965,18334,92322,13183,151804
1011001,79037,69005,19412,11756,179210
1011002,99074,39150,62861,92712,293797
1011003,63035,77886,82795,58404,282120
1011004,61571,15114,21525,81029,179239
1011005,12818,69307,48258,71352,201735
1011006,73250,57806,4243,66317,201616
1011007,73984,32716,99418,65036,271154
1011008,42496,73793,9287,28383,153959
1011009,89292,76662,98297,22671,286922
1011010,33326,88153,16829,77174,215482
1011011,18260,50412,54596,56163,179431
1011012,55399,78505,96458,36090,266452
1011013,47317,47177,32857,74539,201890
1011014,14514,28352,8782,70092,121740
1011015,867,94090,42549,60654,198160
1011016,5231,90501,85605,51344,232681
1011017,32844,23637,65755,90093,212329
1011018,82529,30072,90535,11507,214643
1011019,8943,62813,62404,70532,204692
1011020,5160,52893,52202,58533,168788
1011021,93637,36829,39575,64093,234134
1011022,35815,82293,55822,73093,247023
1011023,27155,36900,24851,95901,184807
1011024,52609,93062,9214,99839,254724
1011025,74002,4810,29233,81893,189938
1011026,96840,2020,39550,48884,187294
1011027,2585,85868,70057,84585,243095
1011028,2779,89589,5891,96673,194932
1011029,69929,56946,5234,79664,211773
1011030,67106,90091,86081,87471,330749
1011031,78121,95432,93095,27229,293877
1011032,77625,26674,18972,91303,214574
1011033,84333,95183,87859,65230,332605
1011034,6563,86855,9898,31299,134615
1011035,30737,55021,61157,82454,229369
1011036,62324,40450,20788,36425,159987
1011037,53967,54167,6424,72901,187459
1011038,5128,55884,86138,28499,175649
1011039,85849,67622,81161,7011,241643
1011040,80057,21121,5634,63377,170189
1011041,22542,83082,22929,13235,141788
1011042,57755,44494,60836,18599,181684
1011043,90889,54735,25469,39769,210862
1011044,51729,14190,16001,75557,157477
1011045,87372,98029,16148,45091,246640
1011046,59800,46557,81476,40687,228520
1011047,6715,8032,30448,39333,84528
1011048,31324,58635,81108,2506,173573
1011049,91497,87298,80418,99313,358526
1011050,36498,48690,4969,33056,123213
1011051,50560,62835,25228,59200,197823
1011052,89141,74001,85824,9238,258204
1011053,59959,77820,98241,30109,266129
1011054,70478,89684,36504,32522,229188
1011055,29017,35233,34214,64341,162805
1011056,91167,46919,25516,16147,179749
1011057,23032,10598,85458,7517,126605
1011058,12613,21629,90253,90230,214725
1011059,96486,45065,27342,98412,267305
1011060,49185,94790,6273,56767,207015
1011061,60787,36417,19941,57421,174566
1011062,54463,23796,93506,5970,177735
1011063,86687,49468,40310,20102,196567
1011064,76156,75202,65121,67443,283922
1011065,50302,7543,73205,26204,157254
1011066,59875,49856,84004,62793,256528
1011067,17717,508,46695,97889,162809
1011068,69411,73812,68367,36639,248229
1011069,20483,97403,22201,9072,149159
1011070,2491,78859,13853,90474,185677
1011071,71877,99854,46948,57944,276623
1011072,4270,97858,55204,71705,229037
1011073,96214,98895,18848,92190,306147
1011074,1143,8251,63265,8282,80941
1011075,31034,92378,81658,80442,285512
1011076,14081,91018,74579,80471,260149
1011077,20244,28413,67972,44800,161429
1011078,67715,96648,85034,83493,332890
1011079,30754,19814,47155,96948,194671
1011080,35667,10356,35008,63703,144734
1011081,85611,99450,20709,98473,304243
1011082,30077,86413,5827,51596,173913
1011083,89181,73050,95272,74306,331809
1011084,9483,63761,25943,30338,129525
1011085,80282,20047,40235,10086,150650
1011086,34606,88709,76481,54479,254275
1011087,84465,94312,90322,24267,293366
1011088,38002,53147,46383,4626,142158
1011089,74051,2638,17542,61653,155884
1011090,74880,60037,85408,20329,240654
1011091,16834,83124,53004,80604,233566
1011092,64065,42204,69467,22278,198014
1011093,33253,40341,97715,46232,217541
1011094,73536,59147,55735,68161,256579
1011095,96038,22425,36493,73377,228333
1011096,84800,56231,60123,55630,256784
1011097,15782,32392,75782,33530,157486
1011098,17457,89931,90316,32123,229827
1011099,15720,25172,24672,48991,114555
1011100,18715,26972,31648,20003,97338
1011101,15039,27726,65333,46189,154287
1011102,62385,81849,85724,87748,317706
1011103,87253,99598,19896,56953,263700
1011104,16675,30709,71034,75022,193440
1011105,93423,40145,96951,46149,276668
1011106,80076,24410,16495,18998,139979
1011107,35540,7726,13773,2905,59944
1011108,58658,5994,94323,86252,245227
1011109,76313,21708,52810,86834,237665
1011110,5893,40370,10002,77084,133349
1011111,21654,18862,26534,14234,81284
1011112,34859,80902,18597,101,134459
1011113,76154,60973,65122,50255,252504
1011114,96504,67559,5539,97877,267479
1011115,75661,4280,95482,75934,251357
1011116,25474,21435,65713,62966,175588
1011117,61435,81872,81265,84153,308725
1011118,21754,55257,20671,27289,124971
1011119,37664,8340,58359,25379,129742
1011120,70534,43259,69727,75522,259042
1011121,34847,69034,50202,40100,194183
1011122,36191,60462,39535,98383,234571
1011123,25870,15041,51935,51664,144510
1011124,99566,74797,455,81677,256495
1011125,6740,43848,72288,27439,150315
1011126,94239,29075,40743,12692,176749
1011127,35629,82483,50872,69727,238711
1011128,30615,22510,42389,41209,136723
1011129,4986,32466,3247,22328,63027
1011130,92428,67826,34693,79281,274228
1011131,91708,99876,56782,67967,316333
1011132,48208,92366,9053,4132,153759
1011133,56052,53393,21297,35431,166173
1011134,9239,58081,85327,95350,247997
1011135,26547,21127,38876,66214,152764
1011136,56542,90330,29815,18000,194687
1011137,63839,81823,8411,99430,253503
1011138,25117,95417,68877,45046,234457
1011139,39276,80831,37677,55049,212833
1011140,28718,82782,87458,40484,239442
1011141,76294,32614,25268,31200,165376
1011142,30427,83786,83684,17595,215492
1011143,79964,23398,24689,66598,194649
1011144,94426,478,28445,9975,133324
1011145,44423,83596,18093,588,146700
1011146,23232,7475,81791,87650,200148
1011147,63043,46350,11572,30535,151500
1011148,38806,20639,35922,58388,153755
1011149,29180,10279,75490,38818,153767
1011150,4835,23009,14491,33979,76314
1011151,48162,7135,46189,69978,171464
1011152,98833,76754,435,80652,256674
1011153,330,60434,759,13972,75495
1011154,48227,62313,81060,27014,218614
1011155,58190,62040,77773,14483,212486
1011156,18145,94765,63122,61718,237750
1011157,96520,99456,98750,96765,391491
1011158,34874,53496,31007,2916,122293
1011159,43971,42055,78857,28370,193253
1011160,64177,83536,77931,27752,253396
1011161,49090,33008,80066,58438,220602
1011162,48208,94274,3694,52527,198703
1011163,80318,98119,42311,25856,246604
1011164,17701,23427,13812,56019,110959
1011165,30872,50781,67456,78203,227312
1011166,8410,56983,19451,58692,143536
1011167,23029,53176,94341,65484,236030
1011168,91711,49415,93683,47132,281941
1011169,4099,10457,31147,4794,50497
1011170,84311,69332,82727,85704,322074
1011171,46125,19121,57278,30019,152543
1011172,79945,73145,88395,95281,336766
1011173,73382,36806,33722,71681,215591
1011174,69649,22871,72707,16103,181330
1011175,96305,43938,6161,93953,240357
1011176,49789,14104,29270,21415,114578
1011177,95726,60940,6859,47819,211344
1011178,61850,58601,89358,92737,302546
1011179,3234,93269,1322,17558,115383
1011180,99585,97039,6567,75130,278321
1011181,35722,63287,21901,31475,152385
1011182,76819,73155,40576,64300,254850
1011183,84337,5331,95591,1550,186809
1011184,78202,751,56510,61825,197288
1011185,77102,97661,48112,63434,286309
1011186,70097,99828,70235,29580,269740
1011187,83660,89715,80716,81040,335131
1011188,82926,93903,55642,81417,313888
1011189,89155,61000,41022,42314,233491
1011190,4467,3562,20956,86197,115182
1011191,41309,79132,92969,63950,277360
1011192,97519,41055,37058,44050,219682
1011193,5,80780,66842,33641,181268
1011194,27815,8876,26648,54289,117628
1011195,83196,65789,547,82571,232103
1011196,35488,19878,88562,8616,152544
1011197,6109,99993,31832,30925,168859
1011198,79190,6450,19489,11671,116800
1011199,51397,29295,70774,75258,226724
1011200,74895,574,54136,14125,143730
1011201,97514,59871,14248,76296,247929
1011202,34903,48536,74821,46142,204402
1011203,76006,71615,2760,73048,223429
1011204,10036,78779,21242,1459,111516
1011205,82705,55912,27882,56337,222836
1011206,48875,11899,56348,22915,140037
1011207,57050,51577,66919,70250,245796
1011208,57749,63191,51902,32692,205534
1011209,51102,46522,67022,26210,190856
1011210,21782,9331,9529,69682,110324
1011211,24740,98579,70945,32616,226880
1011212,89472,41518,58750,18448,208188
1011213,60972,40570,47809,44931,194282
1011214,88825,62047,31227,24199,206298
1011215,69359,78674,44752,87258,280043
1011216,56946,87854,41824,29109,215733
1011217,60439,49138,90591,28461,228629
1011218,91404,71748,2160,20516,185828
1011219,32515,53609,60838,1581,148543
1011220,17207,1138,25924,89248,133517
1011221,61578,61497,88744,38363,250182
1011222,53175,95509,28177,99743,276604
1011223,82641,65369,34295,45760,228065
1011224,32781,28190,28609,82245,171825
1011225,84463,44886,32936,53467,215752
1011226,98253,11115,55256,85191,249815
1011227,75224,89957,81339,52800,299320
1011228,22541,72824,85414,69465,250244
1011229,99771,57320,66167,46618,269876
1011230,83612,23372,4808,33438,145230
1011231,46639,62933,41525,33965,185062
1011232,83342,34252,85581,6554,209729
1011233,9578,78089,82764,44500,214931
1011234,96979,83856,8409,63782,253026
1011235,63815,83589,2896,44820,195120
1011236,20212,85922,96115,78581,280830
1011237,75812,60155,72675,22091,230733
1011238,91276,9400,72013,99232,271921
1011239,41786,11661,8152,4118,65717
1011240,49411,88896,25871,43836,208014
1011241,14352,64621,80534,41991,201498
1011242,23667,73605,66084,70991,234347
1011243,33974,50700,88311,15208,188193
1011244,49751,25028,41988,74231,190998
1011245,26683,1000,22587,73594,123864
1011246,89060,58453,51034,55409,253956
1011247,47196,70502,35088,66096,218882
1011248,21986,54599,35826,42124,154535
1011249,67732,59334,26108,47247,200421
1011250,12846,92567,54090,7733,167236
1011251,5797,90743,33948,65766,196254
1011252,94817,74683,25727,52560,247787
1011253,95717,60883,62252,77049,295901
1011254,45312,26900,34282,10226,116720
1011255,79831,54902,10355,82712,227800
1011256,4343,81832,93891,63700,243766
1011257,36095,84906,97291,34109,252401
1011258,71315,5994,96242,2609,176160
1011259,5283,63961,61639,94634,225517
1011260,19858,14433,12432,76372,123095
1011261,8030,35590,51579,49718,144917
1011262,88069,69181,7802,64159,229211
1011263,78676,37034,95780,43430,254920
1011264,74746,26514,18740,60035,180035
1011265,98559,18452,70181,96395,283587
1011266,33060,37975,39651,11100,121786
1011267,94887,29188,69766,39894,233735
1011268,33167,51159,12309,29087,125722
1011269,40310,32554,76368,68063,217295
1011270,93853,62473,14195,65563,236084
1011271,67669,99928,14597,11629,193823
1011272,83122,20843,3261,33225,140451
1011273,59685,20470,80019,98739,258913
1011274,91850,21362,21094,33630,167936
1011275,47181,97437,61820,19419,225857
1011276,49862,59801,90490,14698,214851
1011277,83360,19469,82535,66385,251749
1011278,5774,72474,5623,62289,146160
1011279,47504,56451,58086,15973,178014
1011280,2376,60838,78863,8421,150498
1011281,98659,16177,75870,87611,278317
1011282,27988,59910,10973,2614,101485
1011283,19280,96589,65382,56323,237574
1011284,25101,87823,35288,69455,217667
1011285,29843,27153,69155,13050,139201
1011286,61814,26625,50250,42153,180842
1011287,44499,52713,4003,25248,126463
1011288,24035,16945,85404,84875,211259
1011289,67975,87927,25685,40008,221595
1011290,73650,20311,27614,61668,183243
1011291,44727,62283,88937,84590,280537
1011292,44760,12706,74405,43438,175309
1011293,86677,43923,37749,17684,186033
1011294,29239,25668,35958,2627,93492
1011295,51177,80347,69262,31700,232486
1011296,75060,72208,38823,63431,249522
1011297,88846,35376,50178,57265,231665
1011298,48072,22665,52341,5427,128505
1011299,21360,27471,52481,29023,130335
1011300,68294,82216,69806,74234,294550
1011301,8598,18151,1710,59029,87488
1011302,42118,89735,90278,71173,293304
1011303,14695,42740,14448,92587,164470
1011304,963,80047,42631,34396,158037
1011305,32394,48834,45564,78289,205081
1011306,64324,48659,6745,67528,187256
1011307,59329,71997,86572,94180,312078
1011308,38587,23735,62351,99764,224437
1011309,99648,61253,35914,77832,274647
1011310,57383,46824,76706,52654,233567
1011311,533,36479,3684,93266,133962
1011312,2634,9744,7552,82795,102725
1011313,55573,82973,77791,63210,279547
1011314,11243,13353,86029,1694,112319
1011315,23091,92089,48673,89604,253457
1011316,43308,53243,68901,96862,262314
1011317,38731,80388,91228,27563,237910
1011318,99768,97971,70762,71749,340250
1011319,56897,88114,43463,61868,250342
1011320,57294,36748,3378,648,98068
1011321,30212,83961,65811,94885,274869
1011322,51196,41807,52352,24014,169369
1011323,4854,53957,52643,20838,132292
1011324,5231,1239,81083,2284,89837
1011325,32890,84974,15747,23934,157545
1011326,17832,30195,69911,82904,200842
1011327,61684,51253,94075,33984,240996
1011328,35376,99628,99410,55987,290401
1011329,22006,26479,877,98658,148020
1011330,49608,99461,56995,47869,253933
1011331,26114,98447,56371,9465,190397
1011332,44894,40953,20935,26450,133232
1011333,99089,61472,30444,87978,278983
1011334,83857,77484,73822,96726,331889
1011335,68056,78318,9850,2826,159050
1011336,21578,53127,72361,62546,209612
1011337,50687,93371,36142,33509,213709
1011338,44337,39914,22809,37713,144773
1011339,69861,44755,24623,27179,166418
1011340,45134,5182,82383,85458,218157
1011341,17120,7949,27917,34772,87758
1011342,50702,45521,81376,41934,219533
1011343,7610,97549,55122,41672,201953
1011344,45210,72357,92725,2640,212932
1011345,43096,91242,49205,7572,191115
1011346,53595,33736,17617,50902,155850
1011347,91107,63614,58018,78709,291448
1011348,97122,24220,95352,63817,280511
1011349,82545,7323,75233,95254,260355
1011350,28337,97955,22871,53738,202901
1011351,24369,85398,46717,80008,236492
1011352,30289,21073,17537,74155,143054
1011353,51490,60891,93351,43765,249497
1011354,51897,873,98457,71870,223097
1011355,93296,98124,99719,12802,303941
1011356,65011,39982,20755,52556,178304
1011357,2964,72744,39328,73837,188873
1011358,82165,28861,73457,54795,239278
1011359,76405,3973,12094,49628,142100
1011360,77819,9292,59443,39650,186204
1011361,38314,90408,11615,45071,185408
1011362,82378,20415,29053,51898,183744
1011363,59901,25302,39697,21197,146097
1011364,73078,54569,52840,31810,212297
1011365,32441,55185,10309,71151,169086
1011366,10302,40161,34314,58593,143370
1011367,56747,77224,7916,75606,217493
1011368,56112,41418,23886,6094,127510
1011369,74799,37379,83610,63360,259148
1011370,32095,39983,6240,20517,98835
1011371,52601,60810,36940,85871,236222
1011372,39641,9825,98610,7613,155689
1011373,6002,23175,13086,49567,91830
1011374,88102,6064,68348,85077,247591
1011375,8636,10164,5016,89014,112830
1011376,62585,80192,35327,65835,243939
1011377,69384,2265,5639,98032,175320
1011378,18983,83400,43571,17242,163196
1011379,27524,69969,27258,37347,162098
1011380,96866,60655,84172,46286,287979
1011381,61956,60217,57554,95868,275595
1011382,19890,21845,40877,20101,102713
1011383,71858,36354,31950,12017,152179
1011384,45605,55689,91427,43877,236598
1011385,87617,19519,33126,56155,196417
1011386,11856,20828,31225,77344,141253
1011387,86884,9167,19821,30706,146578
1011388,50956,87662,53547,77878,270043
1011389,66972,95381,99022,61327,322702
1011390,28979,86276,86161,93449,294865
1011391,33059,89536,93229,16143,231967
1011392,61819,40968,97417,80142,280346
1011393,84406,22810,41895,98646,247757
1011394,90904,90723,51977,27012,260616
1011395,82006,83121,44708,914,210749
1011396,64899,16133,84583,67590,233205
1011397,3541,71309,28238,97836,200924
1011398,20155,85440,56153,33827,195575
1011399,29634,37207,49290,80390,196521
1011400,47867,37575,88026,33602,207070
1011401,66905,67388,41157,9327,184777
1011402,59231,35237,27286,79121,200875
1011403,75645,11970,29871,29346,146832
1011404,86005,68336,12246,2780,169367
1011405,84391,34343,20601,52655,191990
1011406,55368,86176,40097,10911,192552
1011407,86155,44128,67205,57851,255339
1011408,45138,81233,82968,50582,259921
1011409,48065,25544,95836,11257,180702
1011410,43446,3441,60143,90268,197298
1011411,60190,71172,77694,59523,268579
1011412,84623,67595,90,9012,161320
1011413,14883,21071,94455,73393,203802
1011414,3682,90884,83045,26059,203670
1011415,86123,82427,95749,94316,358615
1011416,17718,31931,51209,53630,154488
1011417,84221,33256,82259,99743,299479
1011418,34180,28988,50331,97923,211422
1011419,15176,22545,19025,96881,153627
1011420,10831,17697,8004,96531,133063
1011421,80267,48021,49636,20234,198158
1011422,49573,5854,1655,57523,114605
1011423,47102,79461,41090,30078,197731
1011424,72215,92305,12529,77538,254587
1011425,57282,91888,13295,94698,257163
1011426,77360,53599,63592,89864,284415
1011427,84103,13972,11768,4758,114601
1011428,4221,98133,18471,42408,163233
1011429,60811,55449,57799,39919,213978
1011430,66081,36117,74002,63397,239597
1011431,37529,99220,47222,24244,208215
1011432,82340,70252,72535,79151,304278
1011433,81597,50522,90511,98084,320714
1011434,58559,81039,59609,15841,215048
1011435,14902,746,90717,98617,204982
1011436,87149,84611,66754,79870,318384
1011437,81012,7454,60997,61794,211257
1011438,44277,50541,67120,20874,182812
1011439,90015,16605,96028,10567,213215
1011440,85799,62840,14660,54533,217832
1011441,14508,18643,37920,89272,160343
1011442,71051,31331,93857,89927,286166
1011443,92919,75371,99347,51785,319422
1011444,22493,1844,25853,61115,111305
1011445,35506,16294,56018,26580,134398
1011446,65705,67415,4248,56852,194220
1011447,93165,86691,14975,51563,246394
1011448,33298,16397,11210,61827,122732
1011449,87132,52567,44107,24405,208211
1011450,83008,81704,73495,73979,312186
1011451,12119,85620,28290,89160,215189
1011452,51003,94737,10270,31306,187316
1011453,99504,46770,9607,1971,157852
1011454,21602,16312,98097,2261,138272
1011455,64630,39860,66897,74291,245678
1011456,89060,37191,64787,68559,259597
1011457,58671,89917,12672,13547,174807
1011458,87890,14268,75160,24279,201597
1011459,63917,8653,94016,38713,205299
1011460,29525,91282,28414,18376,167597
1011461,84334,20475,16535,94143,215487
1011462,90851,61996,77623,32917,263387
1011463,59356,73609,29194,22143,184302
1011464,83782,64672,99659,28733,276846
1011465,13716,84700,46546,25232,170194
1011466,62119,92476,60017,5716,220328
1011467,98524,68853,92982,71720,332079
1011468,62452,43511,21396,93853,221212
1011469,71464,99608,82816,97468,351356
1011470,4935,56725,42201,24295,128156
1011471,94509,76483,58329,61667,290988
1011472,41206,38193,11172,89866,180437
1011473,72199,93502,42761,92872,301334
1011474,93309,73382,73238,53697,293626
1011475,57681,25307,92196,95733,270917
1011476,16680,88614,20951,76464,202709
1011477,6018,17015,5774,54953,83760
1011478,77956,16901,72855,12349,180061
1011479,78386,38787,23662,40186,181021
1011480,72581,4358,73013,97981,247933
1011481,80672,3683,66723,35605,186683
1011482,40227,25780,54709,94598,215314
1011483,38960,98069,1673,8944,147646
1011484,30039,48256,77232,67460,222987
1011485,82923,63230,95885,45436,287474
1011486,91751,2203,1192,99316,194462
1011487,50728,32881,58752,15509,157870
1011488,92484,19755,5721,47887,165847
1011489,70545,56325,31073,60836,218779
1011490,69511,52400,5224,84985,212120
1011491,26750,61974,58219,90952,237895
1011492,49991,25461,78108,19107,172667
1011493,82514,56511,45350,54104,238479
1011494,13096,19718,69726,93969,196509
1011495,95057,96911,41456,34877,268301
1011496,2851,7737,95154,27344,133086
1011497,45277,69956,9213,45745,170191
1011498,94628,5977,33130,8346,142081
1011499,75705,17934,76258,23786,193683
1011500,10773,47761,96979,37995,193508
1011501,2369,36442,22500,95940,157251
1011502,45639,1052,25282,51071,123044
1011503,48028,88363,38313,11412,186116
1011504,60421,9845,23251,23187,116704
1011505,74023,85552,6349,75571,241495
1011506,84408,20744,39130,31184,175466
1011507,61768,87295,48140,13724,210927
1011508,41511,54013,65912,38054,199490
1011509,36990,33771,36615,86284,193660
1011510,71715,45746,24049,21140,162650
1011511,896,15469,94524,75005,185894
1011512,19436,37898,45367,51362,154063
1011513,23547,41303,15471,65288,145609
1011514,65456,32851,96370,73824,268501
1011515,47020,50451,83645,57676,238792
1011516,23822,30828,33481,51314,139445
1011517,7589,21620,62784,42842,134835
1011518,39617,37398,53425,28736,159176
1011519,41323,95954,1662,62681,201620
1011520,13695,92458,39901,81050,227104
1011521,19670,30503,84892,49049,184114
1011522,78265,23912,98955,78888,280020
1011523,77861,54754,81238,85912,299765
1011524,27838,46398,6381,94514,175131
1011525,9133,81896,69905,425,161359
1011526,80314,48504,77704,47908,254430
1011527,29042,74204,66981,74313,244540
1011528,98327,41381,65661,61911,267280
1011529,37722,27531,32738,93441,191432
1011530,51957,7295,93384,46487,199123
1011531,8511,62941,94724,2,166178
1011532,56465,13950,70732,12559,153706
1011533,39339,3079,12805,81420,136643
1011534,70346,6960,71762,58669,207737
1011535,40308,84255,98018,35489,258070
1011536,85995,61065,64192,83360,294612
1011537,8933,44822,97239,20751,171745
1011538,38704,70903,13441,90554,213602
1011539,42980,99718,40017,36733,219448
1011540,81767,39196,40031,96790,257784
1011541,95457,23738,5655,78100,202950
1011542,80976,99621,37670,19663,237930
1011543,48112,83009,24752,71730,227603
1011544,56831,89842,67064,98939,312676
1011545,42768,37987,44432,51599,176786
1011546,86704,71258,46701,64299,268962
1011547,14257,92984,47991,64460,219692
1011548,81701,19262,76622,93504,271089
1011549,39527,98123,50617,75410,263677
1011550,63745,23600,45223,79445,212013
1011551,29802,85391,60344,30135,205672
1011552,21396,42095,58293,26763,148547
1011553,39219,90674,16303,31297,177493
1011554,71605,81964,77048,35352,265969
1011555,33041,37015,4680,15517,90253
1011556,57045,66876,56914,56949,237784
1011557,520,62411,28004,76973,167908
1011558,46874,74093,42679,67965,231611
1011559,13868,28947,55455,10150,108420
1011560,21009,61813,6838,20487,110147
1011561,53285,28215,30734,84718,196952
1011562,57039,37048,32861,84242,211190
1011563,21684,33650,2218,62654,120206
1011564,7852,42806,94228,77936,222822
1011565,26842,92209,97045,48701,264797
1011566,93102,73606,39062,8128,213898
1011567,87371,34577,61209,80972,264129
1011568,9436,80937,34547,69258,194178
1011569,57246,68324,97642,29270,252482
1011570,91139,15237,6275,87191,199842
1011571,71051,13698,52373,16218,153340
1011572,9161,10545,97290,83104,200100
1011573,42801,76760,30530,64699,214790
1011574,85,77424,50334,19647,147490
1011575,74791,5617,76102,3501,160011
1011576,92031,12967,61672,32789,199459
1011577,56953,14399,22968,34580,128900
1011578,37775,22921,33977,50345,145018
1011579,85955,73363,54493,48878,262689
1011580,72523,2082,31905,82683,189193
1011581,53663,44704,21869,29104,149340
1011582,36637,18414,20542,68751,144344
1011583,39849,18416,16262,45870,120397
1011584,83189,58392,17951,57196,216728
1011585,84991,85937,31337,34924,237189
1011586,68924,95835,63860,67348,295967
1011587,90281,10720,15782,93558,210341
1011588,5020,49242,2540,93903,150705
1011589,43535,21526,46791,66821,178673
1011590,89265,87697,38882,20261,236105
1011591,14797,68043,56360,94710,233910
1011592,92554,33388,29383,26008,181333
1011593,47531,77127,67700,8684,201042
1011594,52964,83897,64662,81246,282769
1011595,85820,54817,61602,58811,261050
1011596,53421,21071,9405,27576,111473
1011597,26477,73982,97552,59187,257198
1011598,63457,58659,14585,54613,191314
1011599,60980,53685,99831,76889,291385
1011600,60546,45159,21280,30076,157061
1011601,59535,39455,15720,93885,208595
1011602,19599,93651,70118,21727,205095
1011603,88432,93793,36686,44915,263826
1011604,84930,61089,11379,49642,207040
1011605,40892,46955,15722,33888,137457
1011606,32815,63908,56223,34457,187403
1011607,44939,44090,38317,6585,133931
1011608,29596,5930,47670,88530,171726
1011609,80061,96051,45284,69363,290759
1011610,81740,94682,61201,86831,324454
1011611,44547,29245,68682,77310,219784
1011612,37814,99943,28312,94481,260550
1011613,8619,56728,58938,32482,156767
1011614,81189,79557,72195,80508,313449
1011615,28744,47344,15848,91623,183559
1011616,53406,53808,32113,54516,193843
1011617,86306,42897,62099,80457,271759
1011618,33589,92602,38658,57277,222126
1011619,9613,46417,24810,57427,138267
1011620,98059,78541,15425,96534,288559
1011621,19275,8601,44068,96261,168205
1011622,96815,45966,75395,50627,268803
1011623,40016,51607,11024,28693,131340
1011624,93989,95179,84714,75539,349421
1011625,16925,92037,29635,15381,153978
1011626,72364,25830,4920,79067,182181
1011627,43779,40279,17000,26745,127803
1011628,93128,51515,34520,71764,250927
1011629,88993,77819,44979,98987,310778
1011630,60759,7939,52456,10457,131611
1011631,85164,33341,58369,92274,269148
1011632,18725,144,292,32791,51952
1011633,51511,41277,29423,834,123045
1011634,38595,35849,86819,64370,225633
1011635,82668,51152,49700,81449,264969
1011636,34830,68046,21081,57170,181127
1011637,33199,15236,46269,35946,130650
1011638,36617,32462,57872,90802,217753
1011639,69263,36356,14531,26026,146176
1011640,30470,88383,92563,79900,291316
1011641,11337,80463,90578,55039,237417
1011642,71459,94382,72032,20541,258414
1011643,34300,33789,64720,82977,215786
1011644,91635,76359,53821,85851,307666
1011645,8011,89871,20166,31859,149907
1011646,65895,58360,1430,93329,219014
1011647,30625,58,80167,36108,146958
1011648,68715,39318,38132,65439,211604
1011649,30204,73497,4526,32424,140651
1011650,79045,17504,88505,95996,281050
1011651,97421,20340,74842,64025,256628
1011652,91658,19755,29281,25580,166274
1011653,72038,52971,49759,89863,264631
1011654,83455,36132,88378,31244,239209
1011655,76143,81049,32595,76773,266560
1011656,35840,52584,74072,19936,182432
1011657,40482,8144,154,60496,109276
1011658,91920,31179,20021,40543,183663
1011659,79664,19197,52551,16299,167711
1011660,99029,46221,20266,76666,242182
1011661,61324,36834,58083,68170,224411
1011662,94781,94012,68375,66551,323719
1011663,49854,46885,89610,52908,239257
1011664,37338,71586,98794,38252,245970
1011665,82956,74041,71093,99100,327190
1011666,95271,74602,50670,52415,272958
1011667,74158,86151,34180,74765,269254
1011668,76337,64382,66305,86323,293347
1011669,30698,24793,22249,9313,87053
1011670,66330,65633,13072,76941,221976
1011671,75395,96178,99680,12440,283693
1011672,82325,36844,65072,26702,210943
1011673,93545,34157,63959,78757,270418
1011674,293,88488,81390,46644,216815
1011675,77602,10091,62029,50751,200473
1011676,94728,21542,68328,27912,212510
1011677,96940,35026,24367,68981,225314
1011678,74214,91589,5230,99062,270095
1011679,41650,65807,67308,14322,189087
1011680,64990,43061,44905,61040,213996
1011681,46341,2857,87840,51544,188582
1011682,83702,49436,84553,20315,238006
1011683,80083,57532,37379,55533,230527
1011684,81348,85242,25918,36670,229178
1011685,13311,80105,34999,67047,195462
1011686,42044,97972,20179,9095,169290
1011687,15701,78900,29633,10319,134553
1011688,96259,83100,50255,89332,318946
1011689,27219,20498,78777,46670,173164
1011690,93526,94494,60943,1284,250247
1011691,65954,56925,31687,26958,181524
1011692,91227,28315,61,62904,182507
1011693,39556,83787,46431,40530,210304
1011694,11755,55981,98528,83592,249856
1011695,79556,77776,4655,88109,250096
1011696,69398,99754,77345,4372,250869
1011697,91956,87362,11240,72190,262748
1011698,85922,19739,77051,65413,248125
1011699,10484,45964,58048,91222,205718
1011700,13823,99582,45640,57427,216472
1011701,60784,80441,68521,98332,308078
1011702,21824,10370,37958,45347,115499
1011703,91297,17640,58649,12253,179839
1011704,65499,44126,36590,83427,229642
1011705,51507,32897,40776,61616,186796
1011706,89263,1367,15992,52509,159131
1011707,63076,36505,65560,56718,221859
1011708,82875,29635,95162,51568,259240
1011709,50701,38677,78638,79346,247362
1011710,17958,66198,17057,331,101544
1011711,3730,12180,75837,17169,108916
1011712,48046,23647,75162,33094,179949
1011713,44228,48323,21227,85258,199036
1011714,63813,33576,91369,35362,224120
1011715,64087,77015,91805,90632,323539
1011716,50893,29743,76468,48851,205955
1011717,37913,30499,84452,64587,217451
1011718,63562,73842,51805,5470,194679
1011719,83482,70501,97628,1431,253042
1011720,53614,73754,55870,79842,263080
1011721,79983,25620,81840,73177,260620
1011722,63617,23868,33742,16676,137903
1011723,47784,59698,82148,77564,267194
1011724,77002,29822,5153,78695,190672
1011725,90497,81070,76633,30709,278909
1011726,36493,94457,17484,30407,178841
1011727,99447,7822,46693,20783,174745
1011728,53287,92381,9658,98859,254185
1011729,23765,48004,2453,71845,146067
1011730,19675,12360,28556,85718,146309
1011731,49085,48097,1501,75942,174625
1011732,30099,50263,16095,34000,130457
1011733,35353,62549,48593,45103,191598
1011734,90714,38134,36967,22784,188599
1011735,45840,58332,87471,5249,196892
1011736,79714,9221,92535,58263,239733
1011737,54468,9726,99715,65484,229393
1011738,51963,85381,18714,22227,178285
1011739,64923,85999,45511,84094,280527
1011740,14123,33236,13186,96088,156633
1011741,97819,87748,89486,43463,318516
1011742,63154,16404,64714,1922,146194
1011743,39057,77963,80507,98753,296280
1011744,52921,16056,68056,7117,144150
1011745,77034,86447,69627,53926,287034
1011746,94154,20118,64560,41886,220718
1011747,11316,53878,89958,45393,200545
1011748,56084,15220,5321,93403,170028
1011749,28015,85687,86223,59121,259046
1011750,97993,38185,20144,14290,170612
1011751,94823,64803,66647,25371,251644
1011752,5961,33644,40738,80037,160380
1011753,11050,70167,24575,67534,173326
1011754,85564,12227,67238,35722,200751
1011755,33035,59579,23394,31601,147609
1011756,66972,71155,61119,33569,232815
1011757,98514,72545,61831,60081,292971
1011758,55625,40154,25052,41316,162147
1011759,53926,6993,1436,38849,101204
1011760,33802,71159,33875,37955,176791
1011761,92942,75967,39547,23679,232135
1011762,99969,34158,81744,12952,228823
1011763,80988,61088,2256,3601,147933
1011764,58217,13839,62620,84692,219368
1011765,88049,70299,47438,24464,230250
1011766,97752,88684,39067,83981,309484
1011767,88157,49182,33990,20828,192157
1011768,10492,46365,34382,73014,164253
1011769,85853,44568,97616,22676,250713
1011770,57767,97698,4794,98604,258863
1011771,51700,80766,44461,69468,246395
1011772,97559,21308,35308,66244,220419
1011773,89274,67217,60728,84430,301649
1011774,41933,73115,42528,26888,184464
1011775,27035,11890,46729,56080,141734
1011776,28159,27350,32694,59929,148132
1011777,69155,98610,52774,84194,304733
1011778,24991,86347,89150,45712,246200
1011779,98317,42613,10654,62044,213628
1011780,37150,7091,50749,51208,146198
1011781,47428,39335,20927,33279,140969
1011782,2860,74158,38999,36373,152390
1011783,93250,8962,68702,93208,264122
1011784,56193,3805,16006,41926,117930
1011785,85642,24098,35536,6950,152226
1011786,97775,29084,96313,84988,308160
1011787,3374,9911,17818,94908,126011
1011788,23050,80020,76481,92515,272066
1011789,32888,71775,6972,41857,153492
1011790,81191,45301,82673,46281,255446
1011791,47689,55697,54343,43888,201617
1011792,69446,25477,48945,65700,209568
1011793,80560,59826,61103,88867,290356
1011794,86375,25027,70860,28605,210867
1011795,36338,9561,54516,28438,128853
1011796,67033,60705,63338,68101,259177
1011797,20277,16040,93816,80739,210872
1011798,89906,87949,89019,88279,355153
1011799,49962,16854,82937,55439,205192
1011800,92960,84765,56683,90403,324811
1011801,50894,70968,97122,90913,309897
1011802,73928,41036,15698,83925,214587
1011803,39148,25247,15839,81044,161278
1011804,52480,80159,7137,12253,152029
1011805,83998,60569,80479,9482,234528
1011806,96526,1332,61790,72496,232144
1011807,61171,37393,36336,48305,183205
1011808,77584,66456,53647,54058,251745
1011809,85292,16767,67449,65627,235135
1011810,61410,84128,34075,53850,233463
1011811,23290,57942,90281,59812,231325
1011812,44790,11567,7883,77568,141808
1011813,40941,94330,75406,86075,296752
1011814,91682,15484,74131,60548,241845
1011815,87988,85847,61154,8559,243548
1011816,93031,48718,59792,79572,281113
1011817,32354,35693,27216,83114,178377
1011818,16935,14736,66246,31895,129812
1011819,17951,16331,46680,17649,98611
1011820,43879,29529,41230,46,114684
1011821,12689,48845,77809,32929,172272
1011822,39669,3325,81147,12129,136270
1011823,93856,43161,8097,37254,182368
1011824,28401,14998,24244,95620,163263
1011825,86171,85343,49557,38006,259077
1011826,796,20898,50593,58957,131244
1011827,75203,97396,42898,50133,265630
1011828,77592,94540,52984,92406,317522
1011829,63231,47498,97464,41843,250036
1011830,66927,47292,88332,53329,255880
1011831,38496,93271,55322,90327,277416
1011832,55279,20845,43779,71769,191672
1011833,47164,86471,75599,90273,299507
1011834,88804,72900,77518,62799,302021
1011835,54106,26678,75896,82517,239197
1011836,85910,18233,25873,54312,184328
1011837,78571,61380,60532,80244,280727
1011838,52783,13851,62313,94404,223351
1011839,40574,81347,64860,91265,278046
1011840,27612,31937,1217,53602,114368
1011841,25023,53523,68668,68712,215926
1011842,78336,14158,90200,58133,240827
1011843,220,30830,10392,63886,105328
1011844,73204,88710,3928,99758,265600
1011845,31733,36954,57561,8431,134679
1011846,70409,84027,974,42584,197994
1011847,23281,21177,22170,11575,78203
1011848,96652,53458,99771,11602,261483
1011849,88936,44505,76866,86075,296382
1011850,14124,51587,26536,85158,177405
1011851,21062,3720,81241,68262,174285
1011852,39785,72772,88424,39584,240565
1011853,48771,93960,19104,53957,215792
1011854,53106,55420,84714,85701,278941
1011855,19663,97967,51059,30918,199607
1011856,5501,35459,58513,14145,113618
1011857,92111,75004,61263,69012,297390
1011858,54241,56819,92324,97358,300742
1011859,99078,53425,40884,77279,270666
1011860,76430,52524,32591,86908,248453
1011861,6114,94986,54339,95527,250966
1011862,37595,90212,15684,53448,196939
1011863,81979,38224,97470,90467,308140
1011864,17370,1651,7378,61024,87423
1011865,40229,89117,84620,73921,287887
1011866,13110,44172,23058,92716,173056
1011867,92771,50932,28331,54966,227000
1011868,71192,96809,28791,71592,268384
1011869,53005,31771,89447,57035,231258
1011870,71145,18111,20285,97809,207350
1011871,88360,56009,73076,62006,279451
1011872,90325,51824,25556,76663,244368
1011873,83480,22193,70810,63697,240180
1011874,75324,97080,43273,93173,308850
1011875,55344,41925,33623,38683,169575
1011876,82635,27809,52291,54184,216919
1011877,38253,62023,43129,95130,238535
1011878,34446,78720,93662,86608,293436
1011879,88376,90870,83609,65361,328216
1011880,26689,94460,9849,91183,222181
1011881,59911,22972,67251,11811,161945
1011882,47433,22655,89366,69569,229023
1011883,13932,20437,9564,62144,106077
1011884,72100,54370,68485,63103,258058
1011885,27518,8782,75163,41078,152541
1011886,25133,69030,80323,60921,235407
1011887,78041,15082,45461,63279,201863
1011888,48477,12386,77601,79126,217590
1011889,40818,26201,94274,17652,178945
1011890,77714,50385,7379,19716,155194
1011891,37996,33872,33215,26163,131246
1011892,34923,50682,20461,37715,143781
1011893,63197,29806,20761,50782,164546
1011894,61214,99202,4194,41739,206349
1011895,24419,20825,40743,63278,149265
1011896,41217,29490,15717,35265,121689
1011897,8423,71790,80587,4246,165046
1011898,48911,97278,49593,55135,250917
1011899,80796,99185,23194,59775,262950
1011900,13130,23341,21776,89145,147392
1011901,47246,10094,10546,1199,69085
1011902,45355,49469,79199,64566,238589
1011903,85232,90790,51498,72890,300410
1011904,4394,85314,62437,86133,238278
1011905,839,30795,1233,64132,96999
1011906,31277,30120,50527,34665,146589
1011907,75767,65532,12151,47472,200922
1011908,34179,41485,16401,59847,151912
1011909,5836,31245,57800,49421,144302
1011910,94824,19156,56594,86790,257364
1011911,51155,75261,54261,87592,268269
1011912,6895,7332,60573,60876,135676
1011913,58522,51007,13484,54628,177641
1011914,23411,64980,11296,54021,153708
1011915,38864,81216,44399,78407,242886
1011916,95937,56062,85473,34406,271878
1011917,66108,72250,48219,5128,191705
1011918,29387,6780,65846,61874,163887
1011919,89487,12103,1335,89842,192767
1011920,5939,93546,38887,52746,191118
1011921,74355,89449,96622,16161,276587
1011922,52881,55011,18160,96813,222865
1011923,21195,78031,93368,93484,286078
1011924,16392,6522,21230,68282,112426
1011925,19808,29704,95812,5626,150950
1011926,46168,24161,47899,88598,206826
1011927,73189,60704,36130,45709,215732
1011928,95994,70716,38078,69532,274320
1011929,19393,74694,62501,60155,216743
1011930,96886,53196,16565,80623,247270
1011931,51157,257,29090,39941,120445
1011932,23240,29820,70622,86505,210187
1011933,81065,92670,74082,41331,289148
1011934,66335,16486,41685,9860,134366
1011935,14745,2802,3995,40026,61568
1011936,10676,2978,75377,36664,125695
1011937,97496,38540,28011,63368,227415
1011938,83316,98732,10515,49143,241706
1011939,27942,91803,86297,35123,241165
1011940,85885,68010,88384,35257,277536
1011941,49503,39747,74781,43045,207076
1011942,42359,52765,61191,36044,192359
1011943,62293,81312,10192,13434,167231
1011944,8511,21741,47850,98403,176505
1011945,89654,55387,16636,86904,248581
1011946,54900,47881,28955,56267,188003
1011947,38650,72031,73406,76559,260646
1011948,61606,71371,18254,44869,196100
1011949,26897,83950,86056,29746,226649
1011950,58335,90629,36474,7772,193210
1011951,14046,28216,12215,91057,145534
1011952,60164,43789,63219,71969,239141
1011953,78694,52011,15803,77530,224038
1011954,89317,25383,87978,97850,300528
1011955,75152,50793,30759,20186,176890
1011956,47573,79774,78246,61562,267155
1011957,72666,1745,8117,68012,150540
1011958,42072,57003,51838,7670,158583
1011959,42844,14389,54998,40393,152624
1011960,13027,51040,27526,97730,189323
1011961,92478,2743,11356,47854,154431
1011962,91832,71809,83074,63924,310639
1011963,68411,89887,35882,74632,268812
1011964,36569,87262,40801,28563,193195
1011965,76029,49444,39959,33577,199009
1011966,50390,25715,62612,32074,170791
1011967,39012,41774,84127,75513,240426
1011968,12241,19887,70901,18121,121150
1011969,73863,2962,42988,52465,172278
1011970,24588,72301,31403,90630,218922
1011971,39786,48017,67346,49475,204624
1011972,66877,63003,75148,83732,288760
1011973,22541,4993,33969,10337,71840
1011974,60499,48301,17588,74603,200991
1011975,3845,17455,74677,50472,146449
1011976,61109,72463,71599,30182,235353
1011977,99132,51790,62240,68903,282065
1011978,12985,23855,51759,50774,139373
1011979,38456,51313,46792,47113,183674
1011980,6475,92032,6040,78146,182693
1011981,69881,1305,71513,62159,204858
1011982,4683,53711,13789,67127,139310
1011983,26045,3646,63099,30320,123110
1011984,4305,85268,10628,18209,118410
1011985,42932,14338,18679,82578,158527
1011986,3603,11026,85702,82765,183096
1011987,1884,82553,23576,80817,188830
1011988,2703,41195,59782,81526,185206
1011989,65757,99774,22798,17533,205862
1011990,80755,80712,71212,19737,252416
1011991,20729,60321,11073,97939,190062
1011992,18989,41148,24030,36888,121055
1011993,88461,39204,63660,27698,219023
1011994,91169,40288,37886,72720,242063
1011995,27183,48578,45108,9873,130742
1011996,90690,70788,8241,83596,253315
1011997,92541,63078,47706,75754,279079
1011998,33143,15028,61928,89852,199951
1011999,73002,41298,81160,60273,255733
1012000,66006,94744,3148,73280,237178
1012001,49465,99535,99759,78923,327682
1012002,43664,53578,92277,32226,221745
1012003,12514,77112,43378,29616,162620
1012004,23249,52112,95811,93269,264441
1012005,14614,61446,31765,14870,122695
1012006,34427,27888,24862,37910,125087
1012007,80001,32683,99155,16430,228269
1012008,75407,62028,10909,7811,156155
1012009,13368,81920,67142,70326,232756
1012010,13917,69739,88369,53171,225196
1012011,25646,74802,81136,11194,192778
1012012,39866,17012,47399,93418,197695
1012013,47607,79285,10318,79382,216592
1012014,25963,10490,14459,48006,98918
1012015,65634,4383,71956,99426,241399
1012016,63142,66624,74188,46986,250940
1012017,62324,21314,16638,60924,161200
1012018,22063,10813,62936,31250,127062
1012019,64780,15815,75648,9862,166105
1012020,27080,82949,69702,4593,184324
1012021,16180,96667,81851,53713,248411
1012022,82856,31333,73826,42574,230589
1012023,70050,66387,3262,90026,229725
1012024,34959,22916,10673,51276,119824
1012025,79056,70658,96936,27063,273713
1012026,95320,73202,64330,50050,282902
1012027,18363,62847,33366,18003,132579
1012028,5365,25178,29465,54097,114105
1012029,84508,23687,82234,16101,206530
1012030,35200,74227,38920,80646,228993
1012031,38644,33789,64222,45812,182467
1012032,76976,84138,63986,85715,310815
1012033,82296,706,68383,62128,213513
1012034,99208,21810,46896,41446,209360
1012035,95647,83182,30969,34130,243928
1012036,38649,45192,9786,5396,99023
1012037,95190,17525,19986,97770,230471
1012038,14422,59458,11867,11959,97706
1012039,18266,27140,44455,83940,173801
1012040,8044,84475,51187,82024,225730
1012041,44551,19040,79353,51639,194583
1012042,53082,87736,71245,11238,223301
1012043,97408,70224,25127,43781,236540
1012044,41770,55768,22346,34319,154203
1012045,32621,80561,64247,40778,218207
1012046,99724,83331,19900,35976,238931
1012047,85297,16016,29569,6673,137555
1012048,95807,27563,72039,28679,224088
1012049,31974,50850,70332,94641,247797
1012050,53697,33867,1540,65472,154576
1012051,39448,68107,76270,71579,255404
1012052,32158,40758,18340,20262,111518
1012053,76526,98486,84353,69584,328949
1012054,67094,2498,59539,41150,170281
1012055,23949,41503,82047,37479,184978
1012056,21867,28194,33396,42552,126009
1012057,61039,29975,39422,44072,174508
1012058,72684,92303,70673,4586,240246
1012059,91799,65548,90651,10385,258383
1012060,28955,25665,40162,4366,99148
1012061,30539,86730,29201,69375,215845
1012062,6841,6214,8366,38021,59442
1012063,14383,14970,12829,20123,62305
1012064,62370,92657,62431,28826,246284
1012065,86572,86138,80027,91845,344582
1012066,37105,43451,30079,87597,198232
1012067,60297,20753,31810,92482,205342
1012068,92989,11160,1942,80096,186187
1012069,81038,87424,1803,5752,176017
1012070,68741,9055,60397,82657,220850
1012071,81910,53994,86226,25567,247697
1012072,48847,73465,36633,72905,231850
1012073,91853,92665,7650,73648,265816
1012074,1235,98641,23572,96707,220155
1012075,5004,14107,4883,72746,96740
1012076,1862,13420,61188,69044,145514
1012077,50518,97152,8599,37091,193360
1012078,60629,55648,66994,45832,229103
1012079,32335,50242,90927,60398,233902
1012080,75239,59417,54626,98985,288267
1012081,55622,38255,67758,9195,170830
1012082,30350,52305,50817,9640,143112
1012083,79260,57497,83410,70648,290815
1012084,68270,33099,35569,84487,221425
1012085,36851,85835,89367,50480,262533
1012086,64506,13632,8047,96616,182801
1012087,18415,71689,90341,35672,216117
1012088,22562,43028,38483,37570,141643
1012089,97889,15048,83343,16578,212858
1012090,97326,25320,92938,54136,269720
1012091,49805,72962,75827,91832,290426
1012092,89621,93142,36330,85390,304483
1012093,69832,70462,66887,88476,295657
1012094,2424,72161,35607,46847,157039
1012095,80768,18033,48765,69267,216833
1012096,64097,67394,47024,38895,217410
1012097,88079,25695,32622,11350,157746
1012098,28012,71433,47254,85588,232287
1012099,20911,38567,56821,67308,183607
1012100,79427,70173,28014,14110,191724
1012101,93612,84652,14592,81772,274628
1012102,58226,42125,27434,14218,142003
1012103,81198,91124,5281,32649,210252
1012104,6855,64464,54603,18849,144771
1012105,5999,21598,70785,85369,183751
1012106,98244,95714,79706,32500,306164
1012107,7035,39501,43506,23109,113151
1012108,91131,5943,1335,11121,109530
1012109,55330,65676,81723,55268,257997
1012110,62872,67827,27095,17688,175482
1012111,88869,34567,15854,78140,217430
1012112,47944,70420,66631,96092,281087
1012113,32495,29810,70499,60004,192808
1012114,253,23681,70001,15021,108956
1012115,42150,14005,9539,11917,77611
1012116,59126,18298,82873,85247,245544
1012117,40541,89033,36925,86088,252587
1012118,8597,67080,33640,4111,113428
1012119,43318,74717,20816,47292,186143
1012120,77913,85266,43005,22737,228921
1012121,90774,87979,5901,87963,272617
1012122,87189,55631,75010,98238,316068
1012123,59825,57715,15059,7241,139840
1012124,8697,34481,40566,42478,126222
1012125,14495,25349,93006,84597,217447
1012126,56881,59441,9877,15330,141529
1012127,31471,77197,62857,13864,185389
1012128,81289,38505,49350,99754,268898
1012129,47556,65082,4205,11434,128277
1012130,81139,38938,27806,59979,207862
1012131,91356,35393,60060,97803,284612
1012132,17258,90384,76190,13256,197088
1012133,7599,11091,69346,8532,96568
1012134,56954,83265,57142,7010,204371
1012135,21979,16988,72860,98267,210094
1012136,97313,48168,58268,30868,234617
1012137,14636,51996,40212,32525,139369
1012138,20756,49928,70215,80171,221070
1012139,84034,76322,72565,33662,266583
1012140,9227,12290,3345,19726,44588
1012141,97277,84540,86266,65347,333430
1012142,89513,27892,84967,4001,206373
1012143,24501,37189,78461,10877,151028
1012144,60469,20749,34804,52259,168281
1012145,96355,25694,70336,78848,271233
1012146,24457,66733,97641,84579,273410
1012147,75195,83617,59817,27050,245679
1012148,34958,98930,76014,60847,270749
1012149,84002,30172,97227,62535,273936
1012150,57134,41543,36890,38427,173994
1012151,55101,64125,56063,66263,241552
1012152,18858,97990,46064,37304,200216
1012153,41178,31382,55942,48035,176537
1012154,65254,67133,88008,64021,284416
1012155,64194,40286,23872,988,129340
1012156,92365,15002,22842,33908,164117
1012157,83559,74745,62594,1818,222716
1012158,18963,88298,51953,37139,196353
1012159,54827,36120,57015,46129,194091
1012160,97111,93647,3283,2980,197021
1012161,93635,83706,67111,98630,343082
1012162,84758,50380,42129,30597,207864
1012163,61035,40323,87386,9515,198259
1012164,22779,65526,25877,17716,131898
1012165,64142,71307,18887,19437,173773
1012166,52248,26806,83227,40107,202388
1012167,95766,46664,82150,11351,235931
1012168,81246,89324,2647,2992,176209
1012169,50411,95581,99042,42029,287063
1012170,5837,4975,32504,38192,81508
1012171,68000,67560,7394,5380,148334
1012172,44290,91077,82336,27756,245459
1012173,62664,26644,39833,37805,166946
1012174,73346,82860,28065,96355,280626
1012175,66918,58155,40981,88509,254563
1012176,27842,57524,48846,52645,186857
1012177,35075,83959,15581,89765,224380
1012178,37156,65974,44375,96433,243938
1012179,59992,28604,15933,72583,177112
1012180,27770,62322,13508,86432,190032
1012181,57618,27490,23273,20835,129216
1012182,84166,78197,12480,1995,176838
1012183,42120,25961,93474,1849,163404
1012184,3973,78732,15307,15673,113685
1012185,58399,98491,55190,59747,271827
1012186,96132,42554,40273,99874,278833
1012187,84679,96093,88833,56198,325803
1012188,26789,32538,37840,87225,184392
1012189,29396,52024,60399,9883,151702
1012190,38756,75661,93108,74146,281671
1012191,60267,80927,39095,4041,184330
1012192,52072,51302,36940,47635,187949
1012193,16383,54963,52143,91785,215274
1012194,73617,10983,66081,10440,161121
1012195,56357,41160,71833,88440,257790
1012196,55940,54139,2783,44573,157435
1012197,80612,8816,72805,85790,248023
1012198,8177,29103,56392,20121,113793
1012199,18699,5809,42758,4469,71735
1012200,77417,43441,41037,67078,228973
1012201,23527,26420,98268,45463,193678
1012202,53506,24157,72946,43018,193627
1012203,86229,8204,49789,19172,163394
1012204,5769,7622,18006,7312,38709
1012205,25821,99744,63332,49593,238490
1012206,8930,48430,77631,89459,224450
1012207,55590,64412,82958,87144,290104
1012208,77267,62138,68218,30479,238102
1012209,41686,25843,61347,24796,153672
1012210,45763,94839,63248,29297,233147
1012211,53795,73419,45281,19257,191752
1012212,7962,54717,77662,53807,194148
1012213,35409,79297,3962,80251,198919
1012214,41249,16635,94499,74710,227093
1012215,59267,88753,35780,21752,205552
1012216,99607,56520,74018,86457,316602
1012217,81756,75051,33010,38873,228690
1012218,38392,71961,20138,72572,203063
1012219,48083,71967,32555,35045,187650
1012220,71797,88051,20759,42489,223096
1012221,88428,35358,6906,49124,179816
1012222,60371,25152,54406,65234,205163
1012223,24696,73267,29924,25323,153210
1012224,51516,19268,41463,47296,159543
1012225,27602,79494,46136,68550,221782
1012226,46175,18040,67344,13625,145184
1012227,6070,43630,6467,61849,118016
1012228,69336,87432,77670,22133,256571
1012229,88783,70527,73918,56805,290033
1012230,26209,65447,94473,33797,219926
1012231,14007,21551,69631,19115,124304
1012232,52413,83005,25336,5938,166692
1012233,61858,12125,44871,8962,127816
1012234,45441,72139,77815,54472,249867
1012235,63016,46906,20818,90699,221439
1012236,69365,80963,77593,47378,275299
1012237,3879,81255,80609,42630,208373
1012238,73431,98177,2016,2963,176587
1012239,24011,44167,92120,11367,171665
1012240,62242,91548,76661,33998,264449
1012241,56614,84956,6328,36621,184519
1012242,71944,54784,66706,694,194128
1012243,62716,28827,76499,65631,233673
1012244,9872,66203,75193,46490,197758
1012245,62883,15638,64939,72287,215747
1012246,94236,29071,88863,81084,293254
1012247,98299,77835,42135,3313,221582
1012248,43672,74420,3701,95648,217441
1012249,36607,3970,14575,64605,119757
1012250,54076,87786,31159,12851,185872
1012251,64078,33950,76080,20761,194869
1012252,44579,80963,57605,72379,255526
1012253,28032,45008,36476,36860,146376
1012254,29813,13940,52138,71528,167419
1012255,15411,20540,73883,56042,165876
1012256,53454,66692,96507,97099,313752
1012257,23403,96728,95150,51130,266411
1012258,53778,26799,28102,22209,130888
1012259,53024,73897,96244,6457,229622
1012260,40710,47108,30737,44215,162770
1012261,89741,76136,15325,5980,187182
1012262,18310,21589,80373,59371,179643
1012263,70975,62700,65124,87461,286260
1012264,47113,48633,5182,81508,182436
1012265,81426,25532,71800,42029,220787
1012266,18154,55784,95908,21007,190853
1012267,24361,59604,52436,62318,198719
1012268,73383,14928,64428,82275,235014
1012269,23456,16812,79909,96713,216890
1012270,47248,54108,25274,73431,200061
1012271,94857,81324,7085,8749,192015
1012272,43600,47610,14563,61086,166859
1012273,57324,13756,48792,71754,191626
1012274,11590,76419,4752,73960,166721
1012275,77031,9117,91547,47988,225683
1012276,14342,51854,43794,61018,171008
1012277,7846,14553,27497,43459,93355
1012278,75178,24663,46799,23866,170506
1012279,3516,28837,76095,97029,205477
1012280,26891,30860,80766,41087,179604
1012281,12065,15160,9105,95359,131689
1012282,86508,10273,60742,57221,214744
1012283,13925,99419,37735,16035,167114
1012284,85955,31968,60816,35652,214391
1012285,29202,8958,24322,91325,153807
1012286,24031,12062,66207,86046,188346
1012287,83063,95170,41633,31642,251508
1012288,25676,72658,63665,16176,178175
1012289,95281,64755,90867,29288,280191
1012290,32273,4891,80937,76149,194250
1012291,95276,7192,86164,81527,270159
1012292,26500,44942,87395,52338,211175
1012293,39448,70799,17741,64714,192702
1012294,46354,61062,38353,63478,209247
1012295,98890,24540,43971,82866,250267
1012296,5810,46828,66402,2767,121807
1012297,64772,20774,25694,35167,146407
1012298,68308,1203,18070,81088,168669
1012299,58385,7505,66227,88721,220838
1012300,96649,8161,59248,44761,208819
1012301,27707,54287,87949,56276,226219
1012302,68597,45185,1207,43671,158660
1012303,15590,72260,26704,57596,172150
1012304,51909,57573,89314,71259,270055
1012305,33409,56566,79921,64312,234208
1012306,78841,58333,41477,72939,251590
1012307,90128,31729,6021,2271,130149
1012308,53026,9331,77204,27419,166980
1012309,93917,82496,45822,97737,319972
1012310,15000,2653,73896,43421,134970
1012311,88760,38977,85540,89248,302525
1012312,32935,52125,55902,22085,163047
1012313,31822,55241,46855,72279,206197
1012314,38041,84274,75912,88651,286878
1012315,51175,44444,57583,24566,177768
1012316,22596,71986,90897,92252,277731
1012317,42811,86376,65361,74680,269228
1012318,95668,84660,6829,46320,233477
1012319,80522,59653,48612,3141,191928
1012320,24401,64077,16939,91381,196798
1012321,71104,46469,79189,52487,249249
1012322,16794,30058,12867,13234,72953
1012323,95679,65534,60930,60619,282762
1012324,65568,3770,86955,26465,182758
1012325,77799,81945,2382,7166,169292
1012326,63634,17252,85137,45579,211602
1012327,30379,2053,45570,83815,161817
1012328,72528,38976,11416,79658,202578
1012329,35748,87087,87291,77838,287964
1012330,33279,86222,82467,98296,300264
1012331,61089,31045,77224,58619,227977
1012332,86357,60250,75281,37256,259144
1012333,80507,82829,5670,39285,208291
1012334,39511,77918,28958,29582,175969
1012335,84493,43842,51852,87577,267764
1012336,97170,22442,93617,35858,249087
1012337,63777,18243,61994,79868,223882
1012338,51790,3595,3613,48806,107804
1012339,40237,66644,93339,54010,254230
1012340,35855,80347,2303,98895,217400
1012341,32949,16511,91610,40910,181980
1012342,99686,12968,89939,37631,240224
1012343,60798,19815,94023,56293,230929
1012344,39106,31090,34587,84408,189191
1012345,57984,61532,89306,18806,227628
1012346,96857,31736,32122,32697,193412
1012347,98645,37574,45608,10591,192418
1012348,88996,83834,39061,25656,237547
1012349,53700,24016,12674,8298,98688
1012350,95043,63635,72095,57694,288467
1012351,18431,85613,66840,79074,249958
1012352,76555,91933,45083,22395,235966
1012353,11878,79828,31266,50150,173122
1012354,83713,14913,85368,83439,267433
1012355,78784,76126,1100,17250,173260
1012356,31759,23853,55556,59120,170288
1012357,24098,40508,453,75801,140860
1012358,84154,18100,90403,56297,248954
1012359,29932,48386,61336,2266,141920
1012360,74602,52514,47239,76058,250413
1012361,50923,82863,99556,95102,328444
1012362,50972,40322,46106,84497,221897
1012363,35933,61917,89070,18791,205711
1012364,48926,36465,17268,25620,128279
1012365,13631,5223,5919,85086,109859
1012366,83634,73713,58069,4872,220288
1012367,78822,73059,70208,8674,230763
1012368,27621,67778,91540,15962,202901
1012369,96450,75590,64674,87627,324341
1012370,32946,98019,40321,73576,244862
1012371,34076,8066,2812,58894,103848
1012372,71441,85787,30305,80554,268087
1012373,46493,89546,32013,64988,233040
1012374,44957,59048,7223,5312,116540
1012375,48380,65351,21772,93422,228925
1012376,85167,88098,18622,72560,264447
1012377,296,78325,55865,52912,187398
1012378,86489,41942,22604,40260,191295
1012379,95490,63532,44671,84588,288281
1012380,57854,95206,51164,66508,270732
1012381,46565,7674,29320,2411,85970
1012382,86762,64811,16742,63480,231795
1012383,50199,31917,22918,90883,195917
1012384,19550,84557,41901,16722,162730
1012385,97187,41324,7442,80553,226506
1012386,75917,96991,97071,95561,365540
1012387,98478,12599,53469,57956,222502
1012388,57931,72229,50946,75827,256933
1012389,89207,32391,28847,60423,210868
1012390,99966,45420,98927,24509,268822
1012391,12384,93976,70642,66051,243053
1012392,26943,35105,62788,42382,167218
1012393,8841,80204,14085,6388,109518
1012394,28394,68230,98599,58878,254101
1012395,12023,52519,39400,40144,144086
1012396,16498,75533,87127,11749,190907
1012397,98903,51728,68990,82393,302014
1012398,12567,81145,34501,63752,191965
1012399,28515,93484,77126,99831,298956
1012400,13728,78973,27056,87977,207734
1012401,14348,27807,44358,74998,161511
1012402,38125,7856,37354,68498,151833
1012403,36286,15790,44913,88659,185648
1012404,78805,83483,59512,97768,319568
1012405,10191,36475,28778,54644,130088
1012406,74744,30859,26927,11378,143908
1012407,72547,715,15364,82233,170859
1012408,45498,361,83077,95430,224366
1012409,41350,7621,97164,50609,196744
1012410,78309,81411,96162,87219,343101
1012411,54321,42998,57046,31065,185430
1012412,87749,5791,88159,23212,204911
1012413,89052,19596,15265,2548,126461
1012414,82847,88861,89898,25432,287038
1012415,16815,35610,2555,34361,89341
1012416,31804,29983,5950,75580,143317
1012417,69736,45175,895,94261,210067
1012418,95338,77676,99287,27417,299718
1012419,23133,68749,21456,40062,153400
1012420,79495,38700,29410,58120,205725
1012421,39795,41437,83490,75066,239788
1012422,44763,98440,23688,19291,186182
1012423,16752,31230,6953,19692,74627
1012424,42275,38253,83388,21303,185219
1012425,41312,33718,13510,71978,160518
1012426,69942,80911,42000,56398,249251
1012427,62506,17647,40781,14862,135796
1012428,62365,81870,31509,71545,247289
1012429,70483,47465,92451,82322,292721
1012430,38416,6449,12945,47032,104842
1012431,26490,78521,67210,26915,199136
1012432,31048,86432,3367,30202,151049
1012433,77649,23058,39757,83923,224387
1012434,99024,81287,74543,52061,306915
1012435,45579,46040,58895,72144,222658
1012436,67260,57785,30884,57556,213485
1012437,15516,72627,39273,60987,188403
1012438,25736,26550,74076,10699,137061
1012439,27810,77119,78282,64726,247937
1012440,84058,95779,62999,41200,284036
1012441,42433,69901,72641,11222,196197
1012442,85116,25024,96109,9791,216040
1012443,1290,83249,44080,81977,210596
1012444,66878,21929,89215,69473,247495
1012445,70110,46615,25360,20644,162729
1012446,69964,17689,61515,37813,186981
1012447,72847,6793,84815,45244,209699
1012448,64031,3971,64181,20755,152938
1012449,67641,94181,49849,14441,226112
1012450,91362,68352,9379,4343,173436
1012451,37665,78436,286,18936,135323
1012452,83919,91054,20889,458,196320
1012453,7779,32001,52870,67184,159834
1012454,32020,94115,31773,27533,185441
1012455,50637,62809,84605,61977,260028
1012456,44869,58280,34706,25866,163721
1012457,82755,71174,64046,45128,263103
1012458,15056,20734,67298,66990,170078
1012459,49077,4829,63048,30653,147607
1012460,7548,8235,17373,79751,112907
1012461,35907,99179,9899,93774,238759
1012462,85040,70511,78777,62412,296740
1012463,99864,80000,18068,76686,274618
1012464,67285,66366,87625,24226,245502
1012465,61011,80048,4244,12620,157923
1012466,80255,86149,71471,50141,288016
1012467,91767,72488,64657,93521,322433
1012468,28259,50281,82011,8260,168811
1012469,1036,38511,88860,11627,140034
1012470,53065,65909,44841,36964,200779
1012471,60413,54420,58430,47933,221196
1012472,54918,72261,60410,58405,245994
1012473,76148,64215,72763,4228,217354
1012474,77220,10849,31291,77240,196600
1012475,27498,30080,98820,64027,220425
1012476,37435,64027,2808,17348,121618
1012477,35789,18230,24067,56706,134792
1012478,74029,4023,4232,61956,144240
1012479,31854,71697,62177,4489,170217
1012480,80729,87242,6525,58998,233494
1012481,79514,44616,25776,1953,151859
1012482,35277,40873,46422,17433,140005
1012483,31161,96722,90338,19159,237380
1012484,43701,13363,86681,55007,198752
1012485,33659,47420,80738,66030,227847
1012486,19898,68952,41093,36752,166695
1012487,57105,31796,86512,62344,237757
1012488,3810,11466,79148,70819,165243
1012489,47037,6175,81352,27001,161565
1012490,44181,62217,72200,39024,217622
1012491,98128,52730,506,94854,246218
1012492,22571,83883,98012,10024,214490
1012493,45690,70074,51592,87880,255236
1012494,22451,39300,24369,33260,119380
1012495,22031,63376,32939,34908,153254
1012496,34795,17642,45541,23708,121686
1012497,33623,20698,4196,90402,148919
1012498,67800,27542,91778,59267,246387
1012499,73849,11285,37179,52177,174490
1012500,35897,71099,1909,49605,158510
1012501,59359,10075,59397,18589,147420
1012502,19159,20690,41865,8861,90575
1012503,32993,3508,70328,54450,161279
1012504,7623,48152,71903,37389,165067
1012505,93645,76615,27729,76624,274613
1012506,37735,92538,3443,39873,173589
1012507,75982,60724,63908,77556,278170
1012508,35619,78960,73589,30742,218910
1012509,50376,49802,75110,86002,261290
1012510,40661,43346,30885,23497,138389
1012511,77439,72334,43874,75589,269236
1012512,75370,43396,33402,75889,228057
1012513,12956,5768,55373,22044,96141
1012514,31086,56694,80388,25646,193814
1012515,58004,72645,15834,29721,176204
1012516,49062,18998,12734,12258,93052
1012517,59906,25416,84469,81613,251404
1012518,86002,72847,42550,10105,211504
1012519,79394,98846,64898,29663,272801
1012520,64822,94782,27643,56126,243373
1012521,52610,11605,44166,12443,120824
1012522,44514,96169,51357,59181,251221
1012523,84596,71913,74686,35388,266583
1012524,27732,23274,75722,54914,181642
1012525,99087,36806,39776,13874,189543
1012526,4106,48643,80086,77,132912
1012527,55289,37815,69609,46348,209061
1012528,39322,39560,77228,98241,254351
1012529,69945,2333,25256,20451,117985
1012530,38765,44101,5349,39398,127613
1012531,81221,88169,20696,66999,257085
1012532,75014,8948,51664,5913,141539
1012533,16812,78767,27472,97483,220534
1012534,94509,17697,47900,38711,198817
1012535,48525,73751,75051,48697,246024
1012536,54108,62016,11054,53158,180336
1012537,38404,76854,51811,90593,257662
1012538,75457,84291,57557,59671,276976
1012539,50051,81556,43231,61365,236203
1012540,34456,71415,6792,67787,180450
1012541,37080,3720,63720,11068,115588
1012542,77755,41288,58033,71477,248553
1012543,60070,56284,22696,95502,234552
1012544,93220,5291,62568,22477,183556
1012545,9128,75174,41307,31420,157029
1012546,97071,51540,4735,45351,198697
1012547,93557,43937,13981,63135,214610
1012548,21993,17924,41940,62762,144619
1012549,37131,72317,11921,23541,144910
1012550,88402,62930,89297,42934,283563
1012551,52780,46295,9389,96894,205358
1012552,10849,30106,4423,2527,47905
1012553,20452,92267,17908,17196,147823
1012554,69815,62575,2224,88245,222859
1012555,40028,93933,30392,56686,221039
1012556,47872,86345,4960,17037,156214
1012557,51867,5297,49854,48037,155055
1012558,67704,67797,16192,15801,167494
1012559,98305,66497,28448,75687,268937
1012560,77404,48887,41436,69342,237069
1012561,59828,49438,63593,58131,230990
1012562,10329,57486,28514,65059,161388
1012563,1756,70054,95347,67803,234960
1012564,51949,55960,98812,77502,284223
1012565,90587,73393,54731,10423,229134
1012566,12410,54232,56362,98777,221781
1012567,6737,13700,64468,29178,114083
1012568,20852,66537,41247,11526,140162
1012569,963,16368,28571,42907,88809
1012570,63616,44417,62600,43228,213861
1012571,51243,6935,13691,8116,79985
1012572,25010,32526,84361,72585,214482
1012573,36616,19340,6256,93370,155582
1012574,35413,52508,73268,59750,220939
1012575,65421,40210,70097,86130,261858
1012576,18156,22022,45564,31584,117326
1012577,55151,7215,49157,10041,121564
1012578,2609,31001,77456,44217,155283
1012579,69603,29381,47958,65423,212365
1012580,81450,13542,52967,18880,166839
1012581,3007,89001,22129,2078,116215
1012582,2311,9755,35099,26913,74078
1012583,45335,34128,42702,46241,168406
1012584,60193,59094,69550,4071,192908
1012585,19575,80624,59174,93776,253149
1012586,98918,23837,44201,89912,256868
1012587,47596,8563,73958,17089,147206
1012588,67769,4631,57454,39405,169259
1012589,79745,1183,40924,78191,200043
1012590,21743,44478,41877,40230,148328
1012591,84646,60714,78545,262,224167
1012592,45400,85745,48856,58085,238086
1012593,97569,67764,52413,41147,258893
1012594,51032,98430,15235,81271,245968
1012595,92125,25980,52102,89936,260143
1012596,26339,95131,36446,57041,214957
1012597,59744,873,16425,88897,165939
1012598,69174,45716,97692,7801,220383
1012599,5443,22039,95596,41688,164766
1012600,37015,35031,70917,75051,218014
1012601,68509,89116,80568,35219,273412
1012602,88617,80950,45967,26435,241969
1012603,89790,49794,92299,27790,259673
1012604,4112,24871,25254,52952,107189
1012605,62844,73466,79863,12241,228414
1012606,55364,74425,78352,69819,277960
1012607,60880,29358,76495,770,167503
1012608,49348,65243,87184,85820,287595
1012609,55065,10249,66672,61219,193205
1012610,88191,45486,25411,23123,182211
1012611,1457,37963,12479,15456,67355
1012612,68437,89783,38637,86007,282864
1012613,55919,64023,90462,44952,255356
1012614,34534,89493,98575,76506,299108
1012615,1805,19037,81262,18373,120477
1012616,93829,34509,7109,12756,148203
1012617,46637,9972,86761,67619,210989
1012618,38093,22137,6879,77421,144530
1012619,65661,58051,55880,18197,197789
1012620,16176,31655,92269,1929,142029
1012621,66443,969,57839,90674,215925
1012622,60648,3551,2276,85477,151952
1012623,51100,89574,8049,44152,192875
1012624,20592,4818,73152,28399,126961
1012625,30668,94803,62716,21977,210164
1012626,19882,48393,26648,63150,158073
1012627,39637,62994,27860,74242,204733
1012628,82253,57823,16976,48321,205373
1012629,60452,62538,51251,4509,178750
1012630,63918,76658,82672,25766,249014
1012631,2565,73091,89297,71202,236155
1012632,6184,22571,27808,35384,91947
1012633,99034,76859,35362,65422,276677
1012634,61617,60545,48581,18058,188801
1012635,57787,92173,24521,794,175275
1012636,60818,43701,68254,62201,234974
1012637,50540,97745,39994,65367,253646
1012638,92986,92732,16311,64300,266329
1012639,76234,93945,1599,34365,206143
1012640,82574,70139,45335,88245,286293
1012641,13518,99454,76897,67203,257072
1012642,93881,97173,95115,78933,365102
1012643,36966,26978,64432,47541,175917
1012644,21546,70366,30057,7779,129748
1012645,26492,18725,81330,34003,160550
1012646,78120,59724,72128,2645,212617
1012647,48786,46654,62920,82135,240495
1012648,19491,62146,95940,68702,246279
1012649,34988,20346,47489,39125,141948
1012650,39856,88464,64520,72249,265089
1012651,4689,73482,41646,98704,218521
1012652,69491,20034,80210,10955,180690
1012653,60428,19702,91407,4273,175810
1012654,66878,27502,14535,10183,119098
1012655,24994,22244,77876,67849,192963
1012656,75577,99534,63304,70691,309106
1012657,83476,14030,57306,8120,162932
1012658,76972,30141,60788,3530,171431
1012659,12187,55883,82399,11045,161514
1012660,81741,71991,77556,74995,306283
1012661,99612,51120,63186,5464,219382
1012662,54129,43112,4689,10626,112556
1012663,15309,12878,29589,13876,71652
1012664,16665,19582,85433,8744,130424
1012665,219,31043,71477,87220,189959
1012666,98425,15520,29325,83452,226722
1012667,27253,94636,6486,46148,174523
1012668,16555,10715,43813,92936,164019
1012669,19185,59399,33103,32326,144013
1012670,42157,48867,58525,90869,240418
1012671,11806,43906,44545,58869,159126
1012672,30497,22407,62042,98523,213469
1012673,90140,36871,14889,58917,200817
1012674,81557,63076,64154,30874,239661
1012675,35178,63088,97358,41031,236655
1012676,14562,24455,73236,54350,166603
1012677,80263,8710,42198,86654,217825
1012678,91083,87577,20354,42985,241999
1012679,4014,51464,95646,68437,219561
1012680,41035,62243,72827,89752,265857
1012681,53166,96366,56576,24277,230385
1012682,49513,29868,47157,50482,177020
1012683,27177,52309,72144,45819,197449
1012684,75778,18602,46431,12065,152876
1012685,96881,97462,22383,59960,276686
1012686,97478,3334,1970,44075,146857
1012687,69424,43260,27090,63953,203727
1012688,72893,74331,97424,9280,253928
1012689,70022,67323,40961,27349,205655
1012690,93033,66447,45885,25350,230715
1012691,13181,12060,46828,41760,113829
1012692,1585,43918,93098,61957,200558
1012693,24228,75767,29044,90898,219937
1012694,37462,27623,44556,10606,120247
1012695,3705,50583,98484,4325,157097
1012696,36662,38511,17721,17280,110174
1012697,54317,57953,73391,91006,276667
1012698,42398,26998,14498,90293,174187
1012699,39475,11917,7466,83929,142787
1012700,47178,32073,19569,63778,162598
1012701,39632,79055,57287,55657,231631
1012702,56126,18839,19264,51517,145746
1012703,79094,8306,28898,43992,160290
1012704,42284,31576,33751,85094,192705
1012705,49817,791,44750,73493,168851
1012706,36651,12610,291,66895,116447
1012707,84117,79700,20740,33656,218213
1012708,54754,58618,12485,50291,176148
1012709,71008,37679,93976,58919,261582
1012710,53417,75018,87787,36905,253127
1012711,5093,41710,12710,39410,98923
1012712,28800,62242,74014,51506,216562
1012713,63024,77631,74233,25922,240810
1012714,4256,26565,75296,48769,154886
1012715,11961,2229,60683,35311,110184
1012716,37163,97671,17262,70217,222313
1012717,44762,92013,73052,3492,213319
1012718,80653,80953,29844,65545,256995
1012719,65976,93757,85975,40878,286586
1012720,38499,6646,26430,54712,126287
1012721,13225,60924,54837,79532,208518
1012722,17004,46521,97953,48579,210057
1012723,86907,63621,42452,39342,232322
1012724,37927,66477,42260,51957,198621
1012725,81378,16937,3653,41615,143583
1012726,55640,20023,86858,52155,214676
1012727,21754,20699,30250,56140,128843
1012728,59550,82753,83275,51890,277468
1012729,62619,42668,15997,96577,217861
1012730,16347,56548,38038,2266,113199
1012731,11673,45725,5031,98916,161345
1012732,31370,58976,22200,95475,208021
1012733,62780,12983,73691,54044,203498
1012734,53159,59935,99601,60548,273243
1012735,14246,8574,81833,47433,152086
1012736,61439,80173,23956,26581,192149
1012737,17741,92236,57301,80598,247876
1012738,60989,25045,46936,89513,222483
1012739,57127,26256,31741,12550,127674
1012740,44993,76237,81310,52736,255276
1012741,18307,96212,96179,97274,307972
1012742,63000,48416,61631,58152,231199
1012743,25480,18525,96467,51131,191603
1012744,96581,8584,64758,87339,257262
1012745,22132,15535,25640,81556,144863
1012746,81793,20702,61805,1059,165359
1012747,97406,48919,2390,66692,215407
1012748,77073,99777,14031,94768,285649
1012749,6561,7605,51186,74536,139888
1012750,37178,87492,60572,64989,250231
1012751,48796,34571,39513,96848,219728
1012752,95589,58696,31205,56206,241696
1012753,71887,58506,24642,89665,244700
1012754,2311,62208,22598,38003,125120
1012755,17983,3572,34201,56739,112495
1012756,48044,83248,1883,91461,224636
1012757,36713,25716,8579,2216,73224
1012758,95430,73,4808,9242,109553
1012759,7446,69810,45550,44533,167339
1012760,45421,43861,94314,15108,198704
1012761,9077,70546,72111,557,152291
1012762,22998,28646,99903,5429,156976
1012763,90131,90582,40623,66271,287607
1012764,63277,85429,76646,10234,235586
1012765,52096,99339,28388,81688,261511
1012766,31775,76735,84240,74088,266838
1012767,22914,98208,1882,99777,222781
1012768,45288,59423,41547,85168,231426
1012769,61553,84904,76683,31411,254551
1012770,12301,93939,22486,3066,131792
1012771,33748,26165,43898,23951,127762
1012772,26786,29322,90921,95929,242958
1012773,790,5140,53413,92139,151482
1012774,17562,15274,70146,20837,123819
1012775,5074,40587,73178,77761,196600
1012776,61852,19676,10596,38684,130808
1012777,77793,31117,24139,83915,216964
1012778,23814,14322,22507,17367,78010
1012779,97836,99848,45561,20028,263273
1012780,32437,58428,64269,60202,215336
1012781,23979,52212,72963,10205,159359
1012782,25505,88498,39258,55586,208847
1012783,23309,45782,82725,8649,160465
1012784,67609,13063,99389,66942,247003
1012785,96508,53845,78384,61643,290380
1012786,56552,50968,47243,54451,209214
1012787,31886,43748,69407,77735,222776
1012788,60773,86560,34170,92493,273996
1012789,73441,20478,78603,20817,193339
1012790,36381,97888,14500,83384,232153
1012791,18797,34617,94075,52684,200173
1012792,55284,17056,85562,52910,210812
1012793,99728,94980,51081,65264,311053
1012794,23807,70302,69143,5054,168306
1012795,14092,77812,50948,12696,155548
1012796,57112,69161,60186,73867,260326
1012797,46754,84531,32317,23266,186868
1012798,47265,95201,32317,84358,259141
1012799,46621,97083,97440,6753,247897
1012800,91010,40215,63821,80249,275295
1012801,91942,96008,87306,17517,292773
1012802,95688,94132,17326,37180,244326
1012803,85017,3640,48933,55836,193426
1012804,88815,6409,64472,75598,235294
1012805,81471,3283,81595,69654,236003
1012806,47571,93903,42255,10113,193842
1012807,41484,44394,28961,32130,146969
1012808,51000,96348,28221,50785,226354
1012809,79700,56114,17215,86138,239167
1012810,99467,65599,2648,63631,231345
1012811,28353,85954,35016,38566,187889
1012812,4098,43924,75435,94069,217526
1012813,45166,10202,79270,41272,175910
1012814,24223,57313,95479,26590,203605
1012815,84184,39567,59563,5288,188602
1012816,97905,98436,27505,65408,289254
1012817,5976,78585,45101,49908,179570
1012818,82868,11114,72668,21651,188301
1012819,24459,1163,42413,80131,148166
1012820,92675,60723,36290,83249,272937
1012821,90015,78882,25072,66913,260882
1012822,21656,59067,676,70965,152364
1012823,96634,63998,79649,9073,249354
1012824,84218,21175,38248,5801,149442
1012825,77517,7072,81443,80427,246459
1012826,60776,57005,23023,51608,192412
1012827,2323,58060,79535,16398,156316
1012828,71240,2823,22461,72156,168680
1012829,21827,91510,98735,99053,311125
1012830,94175,23684,16108,59294,193261
1012831,78086,48998,46895,85291,259270
1012832,45895,61866,99730,39061,246552
1012833,47274,76991,22767,61532,208564
1012834,14508,63457,71497,76745,226207
1012835,22825,91143,11131,78182,203281
1012836,9736,46075,91353,71197,218361
1012837,33071,1005,17536,72774,124386
1012838,84159,37295,88284,25413,235151
1012839,31626,32714,58153,29246,151739
1012840,96722,75166,59356,28674,259918
1012841,32467,81861,98740,10939,224007
1012842,50547,43458,823,76015,170843
1012843,6566,23140,41922,84979,156607
1012844,22084,32763,90052,85378,230277
1012845,37327,40795,79559,88526,246207
1012846,25103,21081,77493,10428,134105
1012847,52401,61648,83665,64273,261987
1012848,21080,63757,95652,26749,207238
1012849,16522,48914,69616,68574,203626
1012850,79749,24854,41843,52588,199034
1012851,72313,50402,66174,93381,282270
1012852,62854,38043,87340,90910,279147
1012853,13152,6732,19723,50146,89753
1012854,43433,38598,32995,1478,116504
1012855,87563,81353,73005,85583,327504
1012856,34348,66510,20805,88067,209730
1012857,79846,84876,74756,90731,330209
1012858,40732,90530,30294,37132,198688
1012859,29563,27242,93192,33542,183539
1012860,73187,92933,54717,19152,239989
1012861,90300,7697,18372,6726,123095
1012862,8989,1790,10353,35776,56908
1012863,39066,21386,54574,42638,157664
1012864,9986,92274,45573,26115,173948
1012865,69599,38785,16896,86886,212166
1012866,57824,33379,79304,12597,183104
1012867,93808,44581,46201,6761,191351
1012868,93866,68203,35617,55609,253295
1012869,14415,84431,7329,8293,114468
1012870,87891,6140,12041,58516,164588
1012871,64600,41289,39156,15657,160702
1012872,2015,54119,45167,80910,182211
1012873,15423,52248,92337,74002,234010
1012874,41373,78431,18890,94095,232789
1012875,70885,79529,67746,14754,232914
1012876,87779,45236,24325,17591,174931
1012877,11184,27577,35281,44257,118299
1012878,46327,18653,58969,123,124072
1012879,33278,75084,67399,11988,187749
1012880,46910,20781,17554,62553,147798
1012881,76565,54369,61441,66222,258597
1012882,47041,90092,53001,97410,287544
1012883,20909,12096,25455,56849,115309
1012884,48832,78578,34232,91081,252723
1012885,97511,40168,8268,52186,198133
1012886,41491,94192,44034,94491,274208
1012887,41620,77976,70025,23896,213517
1012888,17407,4903,36430,7229,65969
1012889,77794,1146,62173,1279,142392
1012890,48636,8347,83221,86722,226926
1012891,67083,19461,40302,45244,172090
1012892,10459,81233,97005,95488,284185
1012893,86325,45436,48924,87924,268609
1012894,80954,32285,6529,70243,190011
1012895,24960,52902,1985,49523,129370
1012896,62542,47051,43651,53673,206917
1012897,68148,47816,74868,69334,260166
1012898,84485,23663,24823,56480,189451
1012899,3444,63096,34778,40615,141933
1012900,49621,71111,40404,39811,200947
1012901,15283,29216,90998,40896,176393
1012902,67779,94792,44746,59021,266338
1012903,69738,82342,75559,56941,284580
1012904,1247,31658,84428,45450,162783
1012905,48371,88902,5313,23141,165727
1012906,38215,76119,22660,50183,187177
1012907,70397,38361,23984,32624,165366
1012908,34422,85991,9947,28457,158817
1012909,94920,53977,3288,34101,186286
1012910,72194,26912,68771,74288,242165
1012911,27412,96769,57351,63655,245187
1012912,97293,44371,79338,29182,250184
1012913,66629,53529,74267,90136,284561
1012914,55781,15325,57925,30764,159795
1012915,96475,96984,32567,4122,230148
1012916,19046,83302,39567,85202,227117
1012917,75692,54825,39980,14989,185486
1012918,39520,30321,7001,66917,143759
1012919,81267,75109,51842,98834,307052
1012920,73012,84589,66793,27140,251534
1012921,9887,83622,21522,27071,142102
1012922,64551,77923,21452,27986,191912
1012923,81799,91556,9967,17831,201153
1012924,42092,3536,54038,64964,164630
1012925,23720,44605,61326,37508,167159
1012926,65344,80374,73873,47373,266964
1012927,51868,95285,61400,77399,285952
1012928,27941,37564,5986,45842,117333
1012929,96312,75385,91806,29878,293381
1012930,94104,92265,33547,28422,248338
1012931,39800,17156,64734,21121,142811
1012932,71823,72580,86037,76765,307205
1012933,66110,78213,17493,83851,245667
1012934,47811,37740,33903,39807,159261
1012935,2674,83846,46372,1091,133983
1012936,4479,15934,95031,33996,149440
1012937,17870,76969,6399,89975,191213
1012938,67082,92030,67640,98315,325067
1012939,18183,59991,5506,70087,153767
1012940,25471,14560,74587,31752,146370
1012941,6742,78567,55370,40314,180993
1012942,70641,79316,63381,81891,295229
1012943,48742,983,33056,36442,119223
1012944,74541,47233,524,44836,167134
1012945,24883,97876,24632,69578,216969
1012946,17232,26186,67382,28539,139339
1012947,20870,23504,82665,38170,165209
1012948,47452,63223,91705,97225,299605
1012949,66602,4249,9480,56643,136974
1012950,72909,1748,65376,49269,189302
1012951,31012,68811,44695,24073,168591
1012952,77323,5250,29041,72813,184427
1012953,58520,56063,72223,26322,213128
1012954,88157,91053,78892,25343,283445
1012955,14031,81552,47144,55185,197912
1012956,86708,97186,91792,34679,310365
1012957,64175,85900,31238,85985,267298
1012958,17546,73188,94696,18340,203770
1012959,46079,7452,86470,79950,219951
1012960,51108,98865,93453,89384,332810
1012961,7489,22697,7685,22575,60446
1012962,55903,92483,72908,51431,272725
1012963,93025,71108,46895,73001,284029
1012964,42834,66917,20284,47758,177793
1012965,57635,57435,6982,96909,218961
1012966,56720,68598,97153,37193,259664
1012967,32209,29537,51170,68526,181442
1012968,52191,59418,83946,13702,209257
1012969,97071,24084,17039,62198,200392
1012970,16131,77103,9039,31113,133386
1012971,6593,92495,56211,61702,217001
1012972,86354,44671,91373,75955,298353
1012973,41238,98064,72462,73077,284841
1012974,35090,99968,21282,34141,190481
1012975,96888,75059,44754,13587,230288
1012976,74234,43590,86087,48535,252446
1012977,68225,27846,1474,94622,192167
1012978,84596,90168,13292,27701,215757
1012979,38611,46089,96758,56150,237608
1012980,26900,21083,48189,3779,99951
1012981,6901,86778,3346,90029,187054
1012982,70246,44607,81606,99238,295697
1012983,79369,25233,9796,42016,156414
1012984,42176,64139,25884,66321,198520
1012985,66387,19186,13994,45499,145066
1012986,99821,13863,2314,38113,154111
1012987,91212,81444,62974,60608,296238
1012988,78180,41360,40803,8116,168459
1012989,94548,86283,51299,13879,246009
1012990,52176,40506,3350,1413,97445
1012991,14622,58317,91818,2252,167009
1012992,98260,61498,97645,36511,293914
1012993,72221,2371,15948,13519,104059
1012994,65911,15934,40803,37483,160131
1012995,99300,93349,90881,15623,299153
1012996,63888,96282,46608,34920,241698
1012997,5219,70172,76368,20008,171767
1012998,22544,38452,60821,39744,161561
1012999,11600,80524,8421,41688,142233
1013000,82740,90639,52462,63277,289118
1013001,77203,78867,48610,91111,295791
1013002,85135,34640,65596,11802,197173
1013003,64699,27998,6210,25167,124074
1013004,9015,88296,91214,73165,261690
1013005,80137,23323,25057,5621,134138
1013006,62942,94306,42374,61253,260875
1013007,53325,55565,33809,10486,153185
1013008,98246,31118,79507,15097,223968
1013009,40293,73750,38088,6965,159096
1013010,67993,95317,43845,68398,275553
1013011,65696,23267,90288,26765,206016
1013012,5049,56434,36125,47871,145479
1013013,15363,84112,12026,21657,133158
1013014,49798,1562,14078,46262,111700
1013015,4259,11256,40201,14982,70698
1013016,18810,63113,90433,20686,193042
1013017,63464,18890,60315,65256,207925
1013018,90479,46291,29684,66450,232904
1013019,16419,21173,66714,81320,185626
1013020,88728,59464,95696,86093,329981
1013021,98539,54583,90456,31784,275362
1013022,34726,92086,44220,14266,185298
1013023,42343,67011,83602,86670,279626
1013024,98351,7809,88610,85450,280220
1013025,33286,38150,52310,43822,167568
1013026,35241,77063,5625,31589,149518
1013027,61863,78262,2674,77722,220521
1013028,31145,94807,88625,98314,312891
1013029,67044,44288,65615,32390,209337
1013030,9524,77452,5900,92529,185405
1013031,92479,63100,43873,6619,206071
1013032,66377,547,75013,75428,217365
1013033,53137,2444,91426,93016,240023
1013034,82231,28867,85144,29347,225589
1013035,88100,4706,63057,60266,216129
1013036,7184,84282,95477,93276,280219
1013037,63780,89639,15432,48672,217523
1013038,83945,60580,30700,47075,222300
1013039,70035,29048,743,51218,151044
1013040,4530,60503,71708,98719,235460
1013041,40746,40503,45475,20411,147135
1013042,57146,78255,37032,38165,210598
1013043,57912,60399,27505,55503,201319
1013044,50870,97972,37137,39432,225411
1013045,96375,35306,67077,10612,209370
1013046,44645,33215,16916,95981,190757
1013047,17820,23298,59688,45137,145943
1013048,45212,52106,71766,28519,197603
1013049,40056,70153,78929,18372,207510
1013050,98657,56199,77901,88795,321552
1013051,85283,113,89349,87708,262453
1013052,52875,61120,76029,3959,193983
1013053,17134,78072,5879,80287,181372
1013054,68211,16221,7393,83801,175626
1013055,63140,73558,47057,55708,239463
1013056,75739,9040,57210,34457,176446
1013057,28965,42447,1705,35295,108412
1013058,1102,4466,67193,85032,157793
1013059,26104,57982,91146,55322,230554
1013060,34619,28134,51427,98403,212583
1013061,14075,53145,78061,96188,241469
1013062,81340,46980,62754,55492,246566
1013063,75120,8446,53197,18499,155262
1013064,79759,87129,22463,22688,212039
1013065,5835,22797,52444,53273,134349
1013066,55380,75708,22098,43286,196472
1013067,75361,17568,14565,9820,117314
1013068,33652,93638,83771,83672,294733
1013069,17639,59208,8640,30641,116128
1013070,50111,29516,93,32940,112660
1013071,38853,84598,74530,1195,199176
1013072,58190,34340,12568,43299,148397
1013073,31912,88625,64366,13040,197943
1013074,49017,67239,98574,30857,245687
1013075,37016,41954,12296,20582,111848
1013076,14723,53579,34254,91521,194077
1013077,87040,63288,12934,52036,215298
1013078,26663,83430,85189,63179,258461
1013079,31735,45256,28042,51970,157003
1013080,84905,62157,74525,15089,236676
1013081,54736,98160,77970,68734,299600
1013082,88513,35049,492,49006,173060
1013083,55778,77002,35877,26820,195477
1013084,29553,46303,74182,34884,184922
1013085,28703,5677,38718,77819,150917
1013086,34007,61745,64507,11083,171342
1013087,47340,53127,52239,28025,180731
1013088,30315,90164,90974,56042,267495
1013089,28353,71856,11840,83052,195101
1013090,76991,62867,69984,38641,248483
1013091,77761,48673,69309,47872,243615
1013092,33236,24025,15407,58047,130715
1013093,30914,48914,25284,99828,204940
1013094,89120,73191,29563,55565,247439
1013095,64058,9926,68073,96371,238428
1013096,65449,48642,99999,2030,216120
1013097,72314,30725,52594,57363,212996
1013098,1709,80289,94546,19290,195834
1013099,97553,44557,11996,14472,168578
1013100,95154,26666,98914,92632,313366
1013101,31062,10330,77822,94909,214123
1013102,76057,7643,81093,81790,246583
1013103,34986,12580,98978,77360,223904
1013104,19623,90654,66401,53985,230663
1013105,53480,21959,6401,24675,106515
1013106,97825,15907,50323,47319,211374
1013107,13922,7828,5181,74049,100980
1013108,67506,36612,35347,54042,193507
1013109,89581,24248,97353,11199,222381
1013110,91350,95716,95029,42885,324980
1013111,72299,52766,60680,98192,283937
1013112,87945,65420,72907,15639,241911
1013113,96331,38040,59710,47342,241423
1013114,29778,74858,96073,79863,280572
1013115,79198,82880,43829,72557,278464
1013116,76929,70591,23170,54262,224952
1013117,40257,43965,34193,87346,205761
1013118,62788,12844,90362,6630,172624
1013119,69145,49249,4219,97145,219758
1013120,99998,91622,42945,255,234820
1013121,70338,26250,45666,21313,163567
1013122,2492,25496,58485,84319,170792
1013123,16794,85229,72418,39174,213615
1013124,93141,43789,13071,28686,178687
1013125,87230,28077,20349,11820,147476
1013126,53213,88436,9790,23018,174457
1013127,10884,46135,64753,80756,202528
1013128,44586,48327,74753,3092,170758
1013129,7795,12128,58602,88378,166903
1013130,5528,25111,29605,38492,98736
1013131,94938,33687,62360,87083,278068
1013132,32777,95471,10629,45889,184766
1013133,63435,52499,49295,17086,182315
1013134,70286,62832,65645,50458,249221
1013135,2556,48287,96337,61960,209140
1013136,63752,59315,1870,91405,216342
1013137,20541,82222,48717,42163,193643
1013138,18403,70152,48403,10384,147342
1013139,58198,63972,5024,17398,144592
1013140,12814,36445,13735,73866,136860
1013141,93418,76490,15967,22629,208504
1013142,73539,3025,92599,30742,199905
1013143,72637,29856,43199,56636,202328
1013144,58702,46426,94768,2015,201911
1013145,28513,97801,85096,69358,280768
1013146,30617,36317,84024,83829,234787
1013147,66261,61150,98846,21865,248122
1013148,90725,56032,6748,89537,243042
1013149,52934,49457,54471,32727,189589
1013150,27273,25703,13726,12480,79182
1013151,67923,99816,83326,68511,319576
1013152,82683,78104,36056,85312,282155
1013153,22949,60203,28386,4653,116191
1013154,84860,5195,35737,41629,167421
1013155,19619,86210,81747,3433,191009
1013156,78662,17278,50185,53784,199909
1013157,4090,31453,75551,63983,175077
1013158,65380,90543,28519,91393,275835
1013159,60309,89537,72257,8404,230507
1013160,97802,9029,5143,8838,120812
1013161,83568,1343,69126,88933,242970
1013162,64727,17870,35213,9687,127497
1013163,55561,14868,41737,97378,209544
1013164,63355,95253,18396,60945,237949
1013165,10381,28094,41335,45504,125314
1013166,97505,67054,30032,44415,239006
1013167,34103,8864,55007,38431,136405
1013168,44933,3485,7224,34715,90357
1013169,5463,15918,27264,18916,67561
1013170,34484,49141,48655,90685,222965
1013171,4240,50355,52502,9423,116520
1013172,56494,85932,89416,52745,284587
1013173,25152,51525,24608,72898,174183
1013174,34471,26521,906,74301,136199
1013175,44937,31437,43922,93791,214087
1013176,84866,2412,3390,24367,115035
1013177,2368,75887,81244,93725,253224
1013178,64425,22452,65759,31179,183815
1013179,7999,35343,88554,44020,175916
1013180,61369,22501,7601,51202,142673
1013181,5518,4188,70286,67566,147558
1013182,18513,97523,92348,63522,271906
1013183,42764,14097,46720,76914,180495
1013184,10393,90051,88782,67144,256370
1013185,43692,33788,5119,16740,99339
1013186,79570,90057,89912,15745,275284
1013187,30497,73115,15884,15705,135201
1013188,25327,36141,75959,47869,185296
1013189,84414,95038,72099,20427,271978
1013190,65882,89182,63596,1583,220243
1013191,29373,4558,20385,88437,142753
1013192,88303,22671,59014,8304,178292
1013193,47071,91540,71615,70199,280425
1013194,43030,64508,84596,90304,282438
1013195,78016,10888,71237,78574,238715
1013196,97797,49792,83185,40037,270811
1013197,76116,54746,39835,60932,231629
1013198,45730,90820,98895,91568,327013
1013199,1531,81763,12919,23917,120130
1013200,69215,10328,26463,69309,175315
1013201,33894,35867,41287,8581,119629
1013202,39,44047,65988,24220,134294
1013203,77611,2084,67881,78380,225956
1013204,90893,98785,1581,14019,205278
1013205,48800,41427,2211,22045,114483
1013206,93376,61483,79421,30591,264871
1013207,42775,16556,37529,93399,190259
1013208,27173,86998,7264,67118,188553
1013209,20724,19463,6243,1236,47666
1013210,42945,90989,16186,28105,178225
1013211,86873,37299,4767,4781,133720
1013212,2207,6863,34258,76531,119859
1013213,6511,47320,93366,38912,186109
1013214,50790,55051,24571,5835,136247
1013215,75207,96795,17515,23762,213279
1013216,16774,81513,53552,72919,224758
1013217,53094,15400,9377,98915,176786
1013218,49887,49974,90600,25693,216154
1013219,12146,62363,22937,61967,159413
1013220,89402,27338,12310,43124,172174
1013221,2436,50866,29853,14191,97346
1013222,93147,80175,28560,55443,257325
1013223,97814,45052,32656,66679,242201
1013224,82980,25055,8441,53638,170114
1013225,52369,34757,83676,93791,264593
1013226,84826,52294,15321,62358,214799
1013227,59633,60548,79880,32315,232376
1013228,63000,18300,2722,67755,151777
1013229,28863,85366,58757,73224,246210
1013230,61886,11961,53987,78031,205865
1013231,75879,31192,6771,10698,124540
1013232,83738,72861,23709,83790,264098
1013233,57452,30714,98068,55870,242104
1013234,32560,87379,34009,73135,227083
1013235,67332,62828,6685,74746,211591
1013236,44111,26700,22846,63324,156981
1013237,42913,72607,81808,54638,251966
1013238,96453,43845,70084,28336,238718
1013239,97168,89396,62087,49395,298046
1013240,44648,76027,66381,6693,193749
1013241,24368,91073,2222,29986,147649
1013242,14638,9483,18765,47210,90096
1013243,31981,63969,84841,87598,268389
1013244,66330,7704,52571,94086,220691
1013245,44701,71536,98690,91732,306659
1013246,71657,64382,92426,86771,315236
1013247,2420,43406,52158,15614,113598
1013248,44969,93322,63640,59644,261575
1013249,63423,79310,83739,39392,265864
1013250,71480,13889,97958,38200,221527
1013251,98135,60707,41840,12995,213677
1013252,69967,9704,4998,43607,128276
1013253,87867,55371,66655,47093,256986
1013254,76457,70048,78280,59891,284676
1013255,31005,53515,32496,24607,141623
1013256,26768,4147,48497,9083,88495
1013257,4704,5279,36341,68542,114866
1013258,33849,19714,71873,44614,170050
1013259,68101,54025,856,61370,184352
1013260,21571,52175,99761,92510,266017
1013261,42924,91541,37477,62870,234812
1013262,76719,91657,89951,90489,348816
1013263,8288,84590,42481,65497,200856
1013264,73419,11069,15191,65397,165076
1013265,34178,39849,27498,37205,138730
1013266,95733,92135,19351,45763,252982
1013267,82879,22054,96038,90427,291398
1013268,42946,27386,8584,14200,93116
1013269,83713,10208,51727,72145,217793
1013270,95507,92091,80817,69004,337419
1013271,86144,32734,96925,32530,248333
1013272,58875,25805,88704,51440,224824
1013273,2254,22900,47881,34957,107992
1013274,59720,17754,40362,92581,210417
1013275,26369,63092,45123,68545,203129
1013276,62908,82642,94231,57272,297053
1013277,33523,29180,97199,18793,178695
1013278,39525,56056,82886,79014,257481
1013279,21492,50277,12799,82967,167535
1013280,42905,24536,83928,29255,180624
1013281,98546,34999,17436,73019,224000
1013282,50343,25627,40228,71268,187466
1013283,47531,90099,73420,7721,218771
1013284,64278,56572,42698,86346,249894
1013285,74179,35068,63105,9912,182264
1013286,12200,9497,60498,1484,83679
1013287,26573,10625,57465,69568,164231
1013288,92625,58465,73455,70711,295256
1013289,49080,81113,45400,44656,220249
1013290,61399,76256,95337,64498,297490
1013291,38470,78955,8130,64652,190207
1013292,20529,62949,21891,15937,121306
1013293,3412,92715,93210,61426,250763
1013294,63238,93775,65431,20021,242465
1013295,326,1025,6134,41023,48508
1013296,23353,37483,32104,63477,156417
1013297,65370,78834,47259,34185,225648
1013298,50934,32860,23995,33776,141565
1013299,68267,66356,30894,56083,221600
1013300,15094,38264,66933,80003,200294
1013301,58528,71088,22131,36094,187841
1013302,77708,84243,60352,35635,257938
1013303,34160,8559,46738,10194,99651
1013304,71694,23365,13218,1193,109470
1013305,4181,25087,33450,33485,96203
1013306,22159,98231,76360,96164,292914
1013307,68012,93858,39333,70400,271603
1013308,42443,16011,85867,34733,179054
1013309,21369,67567,2892,86073,177901
1013310,50449,57068,38827,89540,235884
1013311,47302,4297,18731,5979,76309
1013312,7519,42893,85365,54681,190458
1013313,34907,93312,70733,92674,291626
1013314,20450,79552,74189,23684,197875
1013315,87522,91162,76244,67965,322893
1013316,28160,61538,9010,39248,137956
1013317,28302,87700,6297,71797,194096
1013318,48397,36265,76499,31631,192792
1013319,16435,78996,84251,82881,262563
1013320,23891,52041,38374,8604,122910
1013321,83605,51763,88601,30152,254121
1013322,93576,90626,57602,27944,269748
1013323,51839,8395,41434,70642,172310
1013324,6998,88246,55128,60807,211179
1013325,36078,11687,63506,92890,204161
1013326,1858,61912,40853,58208,162831
1013327,15301,39309,73713,33900,162223
1013328,30066,52184,66453,76320,225023
1013329,57638,16094,61964,13167,148863
1013330,90354,70339,81349,12437,254479
1013331,9528,34942,17421,84001,145892
1013332,99481,40933,49853,45879,236146
1013333,97266,38020,82079,76223,293588
1013334,678,97502,85225,91733,275138
1013335,1104,48923,17906,95482,163415
1013336,55976,54817,75692,14008,200493
1013337,21187,53544,84242,32978,191951
1013338,8758,77008,86600,38067,210433
1013339,65205,20058,87346,38368,210977
1013340,47324,23324,44599,8617,123864
1013341,89017,35977,60698,70556,256248
1013342,31114,17137,90080,34323,172654
1013343,10793,94051,70558,4074,179476
1013344,9740,25096,37007,72800,144643
1013345,86999,13233,38809,73742,212783
1013346,63799,18580,42374,98971,223724
1013347,30513,52885,20863,97087,201348
1013348,20410,11018,71631,78050,181109
1013349,16942,74574,14534,62847,168897
1013350,8159,23654,75218,62214,169245
1013351,42386,60530,41090,81388,225394
1013352,25196,20977,60018,20651,126842
1013353,89825,37139,54482,50344,231790
1013354,47844,74759,63464,56064,242131
1013355,17711,38034,48080,93442,197267
1013356,3240,45124,54082,39297,141743
1013357,99093,60629,50632,65653,276007
1013358,33366,39131,29054,5449,107000
1013359,97257,75703,22458,142,195560
1013360,7346,65854,91007,17530,181737
1013361,9169,21354,30237,88944,149704
1013362,85980,51582,20263,78865,236690
1013363,59884,15089,34803,19546,129322
1013364,66211,41538,21420,16235,145404
1013365,22072,7004,18624,20717,68417
1013366,3952,70232,92517,95547,262248
1013367,54836,49120,44908,79399,228263
1013368,93358,65362,51550,50643,260913
1013369,49144,47786,57531,16201,170662
1013370,86035,50080,86023,81914,304052
1013371,60659,36666,10398,71789,179512
1013372,72494,36902,76404,35425,221225
1013373,83531,68846,97679,89506,339562
1013374,39090,28262,94357,75111,236820
1013375,53960,59127,21313,1981,136381
1013376,38734,80681,16617,50514,186546
1013377,64496,4921,12369,60961,142747
1013378,78754,91256,17633,53894,241537
1013379,64993,86099,65043,12826,228961
1013380,46747,44140,58929,52315,202131
1013381,99260,99280,57713,84552,340805
1013382,21674,81641,28986,55577,187878
1013383,76676,10158,51274,12065,150173
1013384,19039,67400,97027,55235,238701
1013385,35316,37110,77553,72716,222695
1013386,85651,76284,26854,81491,270280
1013387,82713,4697,11837,31661,130908
1013388,52578,3169,12565,36473,104785
1013389,36496,44539,18288,96629,195952
1013390,45402,35779,50957,30138,162276
1013391,20741,80515,6454,77667,185377
1013392,16471,18318,94127,31117,160033
1013393,80751,31401,97435,28882,238469
1013394,71567,51106,14438,45333,182444
1013395,67529,18626,63882,34544,184581
1013396,54453,41043,97904,34391,227791
1013397,97531,32126,73232,50049,252938
1013398,34684,25476,29161,391,89712
1013399,98659,32965,51544,37975,221143
1013400,6838,47268,4960,79913,138979
1013401,59741,36608,49522,62873,208744
1013402,54939,91853,98303,38965,284060
1013403,37119,30182,71550,50103,188954
1013404,45653,38965,57514,2364,144496
1013405,8058,79925,59846,77891,225720
1013406,54015,70031,37311,81502,242859
1013407,78909,15884,76598,45734,217125
1013408,20989,53957,73620,53464,202030
1013409,66660,62611,92319,30663,252253
1013410,47216,42159,63907,16147,169429
1013411,5593,61076,34653,19271,120593
1013412,73228,9169,48279,39666,170342
1013413,48477,77911,24246,98908,249542
1013414,87012,55029,67754,49542,259337
1013415,38145,11193,54481,87300,191119
1013416,53993,36399,53588,6868,150848
1013417,43980,10621,99473,61182,215256
1013418,84221,20037,16974,69352,190584
1013419,25832,54624,18511,15925,114892
1013420,64892,80637,68492,94077,308098
1013421,24031,48749,71595,54973,199348
1013422,29247,92939,49806,75993,247985
1013423,56578,68471,66297,63333,254679
1013424,16104,92099,13815,76021,198039
1013425,68180,12652,38052,99327,218211
1013426,52925,2553,32258,30930,118666
1013427,62319,95421,97201,72407,327348
1013428,33141,65696,91092,75423,265352
1013429,56682,75886,75232,85751,293551
1013430,42947,77500,326,40856,161629
1013431,48835,18750,517,96527,164629
1013432,15963,83880,81272,9364,190479
1013433,49642,38836,57652,93441,239571
1013434,22936,16641,98053,96981,234611
1013435,53739,66370,15375,27485,162969
1013436,38432,74717,66420,26195,205764
1013437,87539,42779,84446,15977,230741
1013438,54601,39393,57602,53482,205078
1013439,50763,69104,52872,41526,214265
1013440,20385,71833,41808,43091,177117
1013441,95764,82387,38487,23658,240296
1013442,31899,47032,50603,91599,221133
1013443,72654,5778,72159,11432,162023
1013444,70387,12608,30341,99596,212932
1013445,63832,11630,6664,87184,169310
1013446,36114,86671,49745,41294,213824
1013447,37348,601,93849,42586,174384
1013448,95502,40535,24431,52691,213159
1013449,12332,96630,69567,62581,241110
1013450,26984,29059,36776,49309,142128
1013451,98757,58995,16403,34970,209125
1013452,48954,46679,90611,98948,285192
1013453,29189,36229,68792,94803,229013
1013454,46987,79802,68507,2447,197743
1013455,90426,79323,40950,75269,285968
1013456,41354,12483,252,43132,97221
1013457,25390,54815,87233,21120,188558
1013458,53671,42635,59864,74212,230382
1013459,85778,96321,34521,7961,224581
1013460,23674,8081,26587,90119,148461
1013461,42477,84009,98088,29015,253589
1013462,17025,4981,12659,27936,62601
1013463,27633,20874,98991,46501,193999
1013464,66855,71484,93148,75917,307404
1013465,25611,7124,50661,36960,120356
1013466,91802,26070,99037,16776,233685
1013467,73863,64328,36923,19890,195004
1013468,857,23898,21084,59903,105742
1013469,69645,74318,63860,67513,275336
1013470,54204,17875,3656,16634,92369
1013471,56988,1685,56509,69468,184650
1013472,91157,60592,72811,35420,259980
1013473,17369,90941,25098,89236,222644
1013474,69278,15814,41941,39237,166270
1013475,88441,68847,7601,53729,218618
1013476,93113,16001,43122,60074,212310
1013477,92714,24636,55239,66989,239578
1013478,73488,34833,52840,84176,245337
1013479,18118,73768,54564,3472,149922
1013480,67335,41793,13150,37997,160275
1013481,69091,25989,9236,41921,146237
1013482,79717,50927,97280,2131,230055
1013483,90638,17172,2254,49607,159671
1013484,41091,80229,61683,43783,226786
1013485,52189,22984,21320,32902,129395
1013486,7331,43850,56055,36785,144021
1013487,74902,52764,50752,88413,266831
1013488,28488,65939,92404,90158,276989
1013489,54428,7895,96270,54417,213010
1013490,30051,31161,88302,32017,181531
1013491,28372,66304,97710,11090,203476
1013492,27409,73595,24074,6237,131315
1013493,49914,26513,28760,20435,125622
1013494,27903,1688,29085,51338,110014
1013495,48330,43924,66653,27089,185996
1013496,74892,88110,61823,51191,276016
1013497,19050,53676,17631,65430,155787
1013498,1633,60053,93399,67724,222809
1013499,32449,21637,9084,90041,153211
1013500,47009,92493,37706,33299,210507
1013501,78912,43222,38489,3220,163843
1013502,47533,55933,54527,94717,252710
1013503,95861,47668,53940,64569,262038
1013504,91415,32224,52400,1732,177771
1013505,26977,21205,16333,15975,80490
1013506,47469,97048,25072,88041,257630
1013507,99488,72366,43357,50636,265847
1013508,52909,21755,36441,68032,179137
1013509,69103,82366,22876,19404,193749
1013510,72943,18872,35235,50512,177562
1013511,30327,43560,3751,32600,110238
1013512,22797,33241,24634,47921,128593
1013513,25684,68841,68932,87225,250682
1013514,14711,4526,82285,61792,163314
1013515,16604,73003,67030,78770,235407
1013516,46702,87036,57922,36451,228111
1013517,36130,97583,97553,22104,253370
1013518,97057,78913,68447,43513,287930
1013519,33357,85201,78912,87458,284928
1013520,78335,80520,88279,50161,297295
1013521,48777,91045,70984,26033,236839
1013522,68679,10361,75912,65583,220535
1013523,78789,68898,69453,12986,230126
1013524,60978,32915,2882,71030,167805
1013525,78380,3506,21887,35609,139382
1013526,84565,94673,22773,36908,238919
1013527,94101,46549,12654,56931,210235
1013528,40730,12888,704,10987,65309
1013529,48704,98329,53682,66049,266764
1013530,43188,80006,85922,40965,250081
1013531,10635,68816,63384,58777,201612
1013532,4624,33616,92146,45138,175524
1013533,29885,84098,61071,92988,268042
1013534,43746,94078,10218,91968,240010
1013535,87218,20672,22073,47314,177277
1013536,44794,52416,16185,46451,159846
1013537,96809,9544,92777,11300,210430
1013538,45205,46825,99627,6649,198306
1013539,42708,59135,52713,68166,222722
1013540,11295,32820,27610,63103,134828
1013541,61112,10504,68388,38951,178955
1013542,77656,9952,17200,58669,163477
1013543,90495,71482,99276,27265,288518
1013544,39886,3180,20271,97454,160791
1013545,57961,94513,58566,71253,282293
1013546,3167,13919,56710,20610,94406
1013547,6895,32969,21220,25764,86848
1013548,92039,94261,52078,61267,299645
1013549,57024,58548,5436,20642,141650
1013550,71507,74837,81834,33988,262166
1013551,18248,27597,10021,44980,100846
1013552,3590,27899,25298,41762,98549
1013553,83978,85810,84629,64355,318772
1013554,34894,72881,65060,27277,200112
1013555,84304,17582,6265,21629,129780
1013556,84872,12816,16376,60478,174542
1013557,83063,32603,92483,65212,273361
1013558,31650,16943,39372,88630,176595
1013559,9397,50590,76906,32892,169785
1013560,95898,66473,26708,84208,273287
1013561,54847,78600,59438,8435,201320
1013562,51603,99116,82940,19918,253577
1013563,80727,47369,78402,68604,275102
1013564,44944,28912,53398,38659,165913
1013565,86650,96196,13041,24729,220616
1013566,83622,7430,81986,36114,209152
1013567,7861,87996,38716,96427,231000
1013568,67576,68253,89446,92299,317574
1013569,82172,16153,63031,35117,196473
1013570,10348,31778,55208,14502,111836
1013571,84082,24091,88415,75164,271752
1013572,33267,18872,22325,54366,128830
1013573,33761,53485,17420,32583,137249
1013574,11717,83967,22669,45159,163512
1013575,20827,91875,40253,62336,215291
1013576,92050,60249,82682,17587,252568
1013577,16088,62778,63136,18799,160801
1013578,74495,19837,69213,63941,227486
1013579,50784,70395,78703,63562,263444
1013580,92518,91706,27670,47642,259536
1013581,29678,91947,24343,12137,158105
1013582,78909,75937,51439,98332,304617
1013583,2171,76306,78031,4049,160557
1013584,46992,29769,92678,49351,218790
1013585,536,63954,12613,7785,84888
1013586,49808,7138,79459,46877,183282
1013587,6632,85604,27677,53652,173565
1013588,29895,13533,90838,11007,145273
1013589,64779,85250,20681,83976,254686
1013590,2018,48455,78307,62184,190964
1013591,91411,69430,41875,59017,261733
1013592,26860,36965,99969,14752,178546
1013593,24752,37219,87246,67578,216795
1013594,22641,93503,37124,66573,219841
1013595,89846,71335,85860,746,247787
1013596,7643,91302,24615,39272,162832
1013597,15870,51529,83450,33098,183947
1013598,21096,48529,75929,58268,203822
1013599,84560,77265,6386,62304,230515
1013600,7268,45183,82837,68661,203949
1013601,87855,71175,79475,78105,316610
1013602,36453,52318,87271,71432,247474
1013603,94209,44735,24530,81115,244589
1013604,89278,33022,16555,868,139723
1013605,87606,87032,80280,34,254952
1013606,42084,71248,5060,47240,165632
1013607,77928,63865,61950,48581,252324
1013608,5408,9529,44152,49353,108442
1013609,51180,32662,27978,27063,138883
1013610,24891,79300,84661,29455,218307
1013611,31117,67798,62183,68905,230003
1013612,39348,58683,80549,92623,271203
1013613,36440,28234,84327,53639,202640
1013614,56387,86059,38927,29564,210937
1013615,15863,71248,76824,21718,185653
1013616,34037,68024,27176,56000,185237
1013617,70138,84514,87624,75022,317298
1013618,80989,78710,22726,6475,188900
1013619,41920,57407,40076,31149,170552
1013620,83303,54130,24576,54098,216107
1013621,67696,6859,70526,9755,154836
1013622,47914,29062,89740,45653,212369
1013623,46069,78562,73068,74583,272282
1013624,89430,48461,60759,80022,278672
1013625,81080,26455,64057,91001,262593
1013626,68976,20417,6743,33246,129382
1013627,28851,18666,12079,60946,120542
1013628,5830,64081,12451,12694,95056
1013629,92200,26590,16508,94254,229552
1013630,50429,82831,11973,17120,162353
1013631,43694,17808,69644,98234,229380
1013632,77708,19035,20417,8368,125528
1013633,72525,56801,89496,16607,235429
1013634,77701,7757,46815,11046,143319
1013635,20110,54687,82169,84676,241642
1013636,46996,15037,32996,42387,137416
1013637,71632,25858,30332,2565,130387
1013638,34926,75158,38946,35698,184728
1013639,94317,31750,94170,69663,289900
1013640,37036,43194,43784,68294,192308
1013641,31015,69083,72049,20406,192553
1013642,79561,3445,63134,44380,190520
1013643,1934,93965,69482,26879,192260
1013644,40867,14176,36396,24420,115859
1013645,20998,12955,75038,13915,122906
1013646,31644,5080,21508,43524,101756
1013647,36381,32697,63779,12243,145100
1013648,35961,39234,82581,88708,246484
1013649,14025,5359,20517,9529,49430
1013650,97606,91622,43106,62472,294806
1013651,54229,89784,70632,70502,285147
1013652,3682,17315,76883,94865,192745
1013653,26599,10710,45179,51307,133795
1013654,81730,89978,62283,23828,257819
1013655,11184,50828,8499,46353,116864
1013656,86693,18097,43346,23260,171396
1013657,26125,76265,53330,16665,172385
1013658,4479,86187,7020,82975,180661
1013659,91875,69139,50789,78671,290474
1013660,971,85457,98343,6990,191761
1013661,83073,95083,62599,15716,256471
1013662,80389,59670,99051,96416,335526
1013663,41803,53752,7022,12742,115319
1013664,99559,98230,20890,61397,280076
1013665,40404,32750,38328,11963,123445
1013666,50461,66898,69709,31689,218757
1013667,14557,93554,56169,78333,242613
1013668,71511,23097,92797,35008,222413
1013669,54474,56902,96924,21065,229365
1013670,3874,96055,44855,28364,173148
1013671,80258,98591,43297,34614,256760
1013672,31888,64714,34182,46603,177387
1013673,81955,22295,31664,52310,188224
1013674,20504,6906,77183,23518,128111
1013675,76639,24932,65023,87911,254505
1013676,23134,84101,80558,53272,241065
1013677,67913,2176,4827,81607,156523
1013678,6332,61244,27112,44299,138987
1013679,95741,94737,94545,27676,312699
1013680,76227,67350,41984,46857,232418
1013681,33797,81532,43691,27171,186191
1013682,32528,60187,26383,73371,192469
1013683,14892,38793,74132,21978,149795
1013684,72306,86839,17035,69440,245620
1013685,11543,57526,59027,96539,224635
1013686,43950,89944,21070,68226,223190
1013687,2190,62362,76177,11827,152556
1013688,25475,70982,88033,66773,251263
1013689,44645,86644,75814,22435,229538
1013690,20568,82312,42434,32037,177351
1013691,52152,36696,53978,51559,194385
1013692,54958,90091,59061,13290,217400
1013693,63965,37910,41558,16008,159441
1013694,23229,61268,11408,1636,97541
1013695,27502,47637,79372,35333,189844
1013696,46685,9190,49341,694,105910
1013697,49344,46406,46436,46597,188783
1013698,73275,13078,89697,7913,183963
1013699,69981,87525,33046,70114,260666
1013700,58085,50644,81367,2222,192318
1013701,87865,40554,72295,70475,271189
1013702,33680,61882,26205,17374,139141
1013703,63635,57140,24725,27743,173243
1013704,99648,11971,35014,92224,238857
1013705,2057,57237,5033,47666,111993
1013706,34060,26060,76693,47369,184182
1013707,73936,1443,93950,20911,190240
1013708,99296,25165,16803,37673,178937
1013709,9468,29906,91254,8632,139260
1013710,11937,83446,48149,3413,146945
1013711,22258,67877,77397,98442,265974
1013712,4244,45345,66464,60794,176847
1013713,22367,48193,55026,28726,154312
1013714,12933,68020,46349,80263,207565
1013715,88900,99668,17973,40134,246675
1013716,51096,77337,84379,47433,260245
1013717,67508,92592,42101,94647,296848
1013718,84537,51672,13146,84812,234167
1013719,4953,47272,23007,36693,111925
1013720,44552,84952,94448,9512,233464
1013721,75425,26326,94858,61784,258393
1013722,87913,14937,91522,44379,238751
1013723,98564,51992,60745,70764,282065
1013724,52884,49739,97505,4826,204954
1013725,16397,17669,58796,190,93052
1013726,46548,65295,77852,18493,208188
1013727,31100,53771,86876,77411,249158
1013728,86806,75007,91690,78441,331944
1013729,73586,53473,23841,12203,163103
1013730,30448,72812,35291,85352,223903
1013731,29669,86267,9648,16604,142188
1013732,64407,70233,23137,31085,188862
1013733,59368,20256,51074,10246,140944
1013734,57253,64695,42357,4186,168491
1013735,94630,83205,70184,59611,307630
1013736,18091,73339,64122,55569,211121
1013737,4457,14354,12050,37909,68770
1013738,22975,47158,7971,1212,79316
1013739,17163,58945,52666,4768,133542
1013740,61004,87094,70389,31681,250168
1013741,11308,59239,42316,39632,152495
1013742,30162,81735,43367,68452,223716
1013743,96151,65555,48982,12200,222888
1013744,79570,60688,73832,50263,264353
1013745,61541,48592,35163,20314,165610
1013746,11110,90657,37884,93060,232711
1013747,58736,11419,93985,32208,196348
1013748,92208,94263,3949,58328,248748
1013749,54128,39522,51052,74221,218923
1013750,88606,47580,91715,16943,244844
1013751,62260,78346,65254,38698,244558
1013752,59674,15332,38428,15507,128941
1013753,78454,9608,28291,55723,172076
1013754,70255,7496,49296,46916,173963
1013755,59243,13389,53228,74490,200350
1013756,21100,12544,69326,72097,175067
1013757,8289,9987,35851,86182,140309
1013758,86191,60677,59330,27423,233621
1013759,29050,39158,89331,62796,220335
1013760,96932,60051,89648,65983,312614
1013761,47284,13215,28569,9301,98369
1013762,2071,25400,57288,29833,114592
1013763,2773,74204,38554,51711,167242
1013764,37127,1466,79037,96985,214615
1013765,24156,41911,55821,2280,124168
1013766,63689,52790,8873,34159,159511
1013767,11011,21885,58174,22759,113829
1013768,9161,64308,90568,8537,172574
1013769,33390,31731,87592,19715,172428
1013770,50070,22561,3605,37574,113810
1013771,92932,35266,24885,96550,249633
1013772,4034,56133,26362,35913,122442
1013773,27348,41185,92648,12975,174156
1013774,93278,33234,6291,85786,218589
1013775,23461,5365,8949,8917,46692
1013776,40488,20309,81479,28910,171186
1013777,30663,62816,68751,34956,197186
1013778,52023,15017,10823,47488,125351
1013779,83561,82232,44275,65684,275752
1013780,117,49203,59026,21088,129434
1013781,6792,43930,90740,95610,237072
1013782,70602,46904,24913,28624,171043
1013783,51025,72615,86041,61249,270930
1013784,96176,67388,64004,38039,265607
1013785,12295,52179,9781,19331,93586
1013786,4991,47621,61017,44127,157756
1013787,66617,53696,44095,75354,239762
1013788,73060,81533,30445,79384,264422
1013789,87940,86430,10378,72842,257590
1013790,17309,1952,16082,15894,51237
1013791,31727,6328,22540,51862,112457
1013792,88362,91010,87396,22410,289178
1013793,2032,3714,2059,68721,76526
1013794,87068,67313,36097,79066,269544
1013795,99896,32055,481,11533,143965
1013796,92605,34239,48124,51655,226623
1013797,71268,89608,4103,44612,209591
1013798,31271,5124,14776,36815,87986
1013799,26759,36465,9394,45834,118452
1013800,14299,35768,18211,45844,114122
1013801,73452,71404,6479,39079,190414
1013802,87246,41017,14431,1486,144180
1013803,55929,26619,20209,86677,189434
1013804,66133,92966,33278,80161,272538
1013805,40908,4620,98021,91914,235463
1013806,40618,89459,20686,24309,175072
1013807,31833,66824,4609,94256,197522
1013808,45746,1209,69202,13160,129317
1013809,41674,58121,95483,55430,250708
1013810,4659,12360,98074,32022,147115
1013811,74320,53737,42490,49810,220357
1013812,7578,41781,75739,2979,128077
1013813,83510,35325,42240,69022,230097
1013814,26225,11866,30625,11307,80023
1013815,98604,41230,36293,74990,251117
1013816,57787,67603,6789,49492,181671
1013817,25283,53854,5555,29952,114644
1013818,12708,99877,9004,29505,151094
1013819,56604,632,75308,19422,151966
1013820,71536,80108,46645,81622,279911
1013821,74400,87728,19115,68603,249846
1013822,26263,38239,69119,53639,187260
1013823,62065,39594,64369,40742,206770
1013824,16383,4860,58011,11072,90326
1013825,49147,44727,22047,38671,154592
1013826,14424,72493,2661,9926,99504
1013827,50737,92709,8206,99415,251067
1013828,10381,65348,98605,34958,209292
1013829,81427,9577,24533,94423,209960
1013830,26987,24819,29682,31834,113322
1013831,85813,60626,19277,76142,241858
1013832,92771,62941,82617,32867,271196
1013833,98052,32213,97303,72894,300462
1013834,75720,81757,17162,71443,246082
1013835,21790,28946,35808,32391,118935
1013836,27328,63688,93413,24198,208627
1013837,6274,61360,95542,98354,261530
1013838,27423,96606,32718,67412,224159
1013839,49658,20242,1716,83893,155509
1013840,31074,97791,77733,61414,268012
1013841,47270,4822,43696,78024,173812
1013842,37657,83997,64305,91162,277121
1013843,24987,72471,57358,34818,189634
1013844,13201,19470,1754,90317,124742
1013845,49658,62967,474,10287,123386
1013846,41615,52996,28393,98897,221901
1013847,10013,3245,24826,45639,83723
1013848,43474,66208,7965,40119,157766
1013849,3512,67721,71685,21202,164120
1013850,3198,93716,9671,12533,119118
1013851,68421,19945,62778,59370,210514
1013852,12693,45229,67311,41694,166927
1013853,36227,38543,52823,93683,221276
1013854,89083,26610,87560,70809,274062
1013855,33491,65041,82414,71236,252182
1013856,14347,21393,36819,2395,74954
1013857,70323,55561,53215,63045,242144
1013858,57722,89398,76149,45500,268769
1013859,90610,10857,62381,19138,182986
1013860,9138,50630,93711,40246,193725
1013861,26781,5865,10019,51939,94604
1013862,29889,46084,8563,68084,152620
1013863,39373,10147,90750,83672,223942
1013864,35691,9812,36434,24488,106425
1013865,66880,99958,73595,49786,290219
1013866,66102,91403,30074,87786,275365
1013867,81932,18314,97343,80794,278383
1013868,7889,52040,34532,82208,176669
1013869,75662,72499,43015,51564,242740
1013870,40458,82744,4530,12432,140164
1013871,61346,78040,55079,86254,280719
1013872,58762,86859,41209,86034,272864
1013873,35439,6539,49144,17748,108870
1013874,79842,39072,79538,2965,201417
1013875,91022,74493,33039,9465,208019
1013876,51283,58235,4161,81924,195603
1013877,43968,82005,91550,25807,243330
1013878,51015,96270,21833,58275,227393
1013879,98853,32081,6594,94499,232027
1013880,70899,43544,96575,77083,288101
1013881,57249,4711,7038,64149,133147
1013882,49018,69982,75868,9865,204733
1013883,22162,80822,95368,72489,270841
1013884,98221,45541,82174,52350,278286
1013885,45073,33389,17509,56893,152864
1013886,49428,79528,66813,82129,277898
1013887,92209,2696,25917,76276,197098
1013888,80580,3223,37179,42784,163766
1013889,35188,99924,64763,74140,274015
1013890,74998,94780,77263,1285,248326
1013891,70704,66117,91896,64475,293192
1013892,54026,41386,96811,68375,260598
1013893,89918,38666,95062,6596,230242
1013894,47505,64535,27250,40661,179951
1013895,20341,9969,76234,69740,176284
1013896,76645,81730,3903,83791,246069
1013897,78856,20040,24077,6587,129560
1013898,55114,68253,83089,63744,270200
1013899,68308,3008,926,78946,151188
1013900,31069,38493,97691,90902,258155
1013901,33297,35657,85041,6897,160892
1013902,95664,48471,90489,28943,263567
1013903,77767,32566,99183,98347,307863
1013904,16171,68515,23503,68187,176376
1013905,32808,16250,3860,37910,90828
1013906,9101,45778,4010,51686,110575
1013907,42411,48502,16428,11908,119249
1013908,98049,52144,63592,5631,219416
1013909,34387,74647,50892,26305,186231
1013910,61606,87804,87011,33961,270382
1013911,880,12371,80915,7081,101247
1013912,89645,48228,50025,92661,280559
1013913,92984,12700,43625,43712,193021
1013914,48910,90759,30452,71590,241711
1013915,75496,24096,60836,10510,170938
1013916,22745,27121,70088,71788,191742
1013917,35929,24775,22818,44868,128390
1013918,59376,99518,51590,84784,295268
1013919,88910,90469,74211,79264,332854
1013920,96831,94342,8685,63035,262893
1013921,98938,15157,59053,895,174043
1013922,35446,33575,2740,15218,86979
1013923,50451,96591,14428,3478,164948
1013924,32936,84873,27619,45851,191279
1013925,45346,32737,22337,42306,142726
1013926,50734,57091,86928,95531,290284
1013927,8668,33517,67961,206,110352
1013928,74199,97259,72875,82961,327294
1013929,48473,13662,17869,30492,110496
1013930,56746,7964,26271,59813,150794
1013931,2104,41691,6201,66117,116113
1013932,46641,59085,9480,56383,171589
1013933,33845,95488,40187,12561,182081
1013934,55574,4231,96469,73849,230123
1013935,134,89611,22053,31879,143677
1013936,97403,28267,32445,29679,187794
1013937,31139,268,35,82203,113645
1013938,35063,69613,44768,72812,222256
1013939,45465,48654,43956,27383,165458
1013940,72295,94825,48351,56106,271577
1013941,34731,83988,354,6566,125639
1013942,84376,72323,98535,84846,340080
1013943,55863,84442,78733,67803,286841
1013944,15357,41404,59343,85369,201473
1013945,75034,2260,71821,97489,246604
1013946,74526,47556,84782,23868,230732
1013947,21097,19049,81503,37148,158797
1013948,18339,29427,31648,91909,171323
1013949,93113,58157,23868,70061,245199
1013950,37417,860,46832,19765,104874
1013951,38486,48179,16703,89388,192756
1013952,21216,18138,88335,21306,148995
1013953,90205,59170,24607,19014,192996
1013954,99564,29191,90826,42215,261796
1013955,99590,5739,60181,82463,247973
1013956,46678,33704,96586,94709,271677
1013957,98278,5525,66367,18805,188975
1013958,31632,50989,16364,78722,177707
1013959,96277,81349,8591,77142,263359
1013960,57613,91794,77149,7360,233916
1013961,74850,4653,79045,99053,257601
1013962,37905,41551,30543,20861,130860
1013963,41101,14525,27686,42521,125833
1013964,23772,91508,26910,36772,178962
1013965,244,74298,98323,64617,237482
1013966,17366,1620,62564,94553,176103
1013967,24499,33272,54160,30564,142495
1013968,93834,30918,79961,79198,283911
1013969,61673,8461,88473,31345,189952
1013970,32359,69084,1250,95186,197879
1013971,18765,85900,94199,25133,223997
1013972,74599,25929,64060,64093,228681
1013973,57743,3726,51945,44641,158055
1013974,84095,56118,95322,83196,318731
1013975,80556,66274,67461,98789,313080
1013976,21752,99686,11520,92778,225736
1013977,59970,75936,25388,18501,179795
1013978,86250,63925,17275,56061,223511
1013979,40386,45927,92661,49799,228773
1013980,40383,53948,52153,69811,216295
1013981,23569,71563,51873,4795,151800
1013982,60430,56049,53770,79498,249747
1013983,50025,8655,35125,54080,147885
1013984,30767,16792,17052,21191,85802
1013985,27167,39195,68959,40495,175816
1013986,58416,25886,4438,7869,96609
1013987,91463,60523,3721,57845,213552
1013988,87981,74217,71084,24021,257303
1013989,8242,79349,60923,74853,223367
1013990,84850,86790,2668,14100,188408
1013991,19250,3604,72835,92488,188177
1013992,55025,83120,96463,86705,321313
1013993,8660,23480,28382,39883,100405
1013994,31718,38326,92750,47113,209907
1013995,50904,28391,25574,13405,118274
1013996,28770,26560,55082,13003,123415
1013997,59283,92891,90266,59943,302383
1013998,34536,68919,30413,69528,203396
1013999,56069,59717,1428,93541,210755
1014000,63554,46748,54698,63024,228024
1014001,63109,89403,21124,73866,247502
1014002,28163,28303,48079,60584,165129
1014003,50191,3210,89433,45155,187989
1014004,81243,33982,79199,18706,213130
1014005,17970,716,7450,23603,49739
1014006,50564,96643,12437,44748,204392
1014007,76317,31274,61229,84386,253206
1014008,26183,15394,3565,26374,71516
1014009,52685,85022,20399,76644,234750
1014010,20646,86982,91166,48533,247327
1014011,49237,14481,58054,64481,186253
1014012,79399,57464,36602,88099,261564
1014013,58249,6442,21069,99612,185372
1014014,15679,67922,71032,91356,245989
1014015,59370,47533,88718,52296,247917
1014016,14013,44917,26209,54283,139422
1014017,71201,55637,2541,74051,203430
1014018,38075,60159,64768,87992,250994
1014019,84920,78460,39652,34559,237591
1014020,33423,56787,26680,75225,192115
1014021,79393,70106,65385,27420,242304
1014022,72815,29536,43415,34243,180009
1014023,58459,72770,80654,66237,278120
1014024,3218,18246,87206,67819,176489
1014025,28453,24199,28568,68375,149595
1014026,20211,20668,9089,83130,133098
1014027,80920,64229,95835,54476,295460
1014028,37986,30749,29403,40042,138180
1014029,66145,99691,48699,77087,291622
1014030,21780,35045,18362,71934,147121
1014031,48302,87729,25303,20143,181477
1014032,21832,27111,37757,78096,164796
1014033,20682,74674,65509,91189,252054
1014034,29013,97119,31181,47088,204401
1014035,80935,88075,26569,9315,204894
1014036,87204,37192,36091,74244,234731
1014037,65007,75884,78463,73271,292625
1014038,85330,82894,20839,65582,254645
1014039,56095,39395,20908,17614,134012
1014040,64998,70995,42496,27497,205986
1014041,6998,90783,832,25717,124330
1014042,37419,3765,25480,17441,84105
1014043,65068,52237,74977,12245,204527
1014044,63897,61939,83530,34180,243546
1014045,13101,53637,50371,17644,134753
1014046,9094,25182,18716,13955,66947
1014047,34595,35830,67736,81398,219559
1014048,21774,81663,16348,98132,217917
1014049,67864,12607,10705,7175,98351
1014050,74621,72560,717,16264,164162
1014051,44403,77135,64821,32183,218542
1014052,69374,84614,81845,12094,247927
1014053,10991,95842,49667,17038,173538
1014054,96486,72378,96796,90909,356569
1014055,35680,9279,52289,55384,152632
1014056,75884,29404,83288,19864,208440
1014057,32491,52610,26208,38868,150177
1014058,84317,69675,51006,71451,276449
1014059,19909,73055,12961,3654,109579
1014060,92806,32020,39800,77340,241966
1014061,46228,36454,21280,72207,176169
1014062,28138,88882,19750,21857,158627
1014063,4094,3891,43361,9342,60688
1014064,94015,37917,52297,3401,187630
1014065,52488,8609,15723,17227,94047
1014066,23006,65782,6139,30800,125727
1014067,13377,42877,75234,11247,142735
1014068,57469,5731,63685,12556,139441
1014069,33812,97978,19591,74287,225668
1014070,51435,37945,44100,10668,144148
1014071,31883,97561,38474,48482,216400
1014072,31763,72967,60395,72724,237849
1014073,163,57722,69549,66173,193607
1014074,23405,39361,72205,62851,197822
1014075,46007,81087,95253,23269,245616
1014076,60745,23693,56418,4183,145039
1014077,92687,76719,68747,46202,284355
1014078,80347,54412,29602,97291,261652
1014079,52266,45622,50669,88888,237445
1014080,83413,35381,22647,572,142013
1014081,58834,73349,3553,58766,194502
1014082,4415,78688,52283,68595,203981
1014083,48383,90944,49102,1148,189577
1014084,74401,55215,99626,80481,309723
1014085,14992,70966,95656,26862,208476
1014086,30849,33484,69231,33849,167413
1014087,84499,96282,72187,98018,350986
1014088,7760,52501,98791,26642,185694
1014089,23530,80030,34891,15477,153928
1014090,98486,57398,33356,79443,268683
1014091,80100,25314,16166,9346,130926
1014092,53806,37296,85067,78740,254909
1014093,20793,13453,32556,12117,78919
1014094,97079,19237,19086,3740,139142
1014095,34010,10764,90258,63897,198929
1014096,70070,230,66034,9273,145607
1014097,52431,31756,4853,53989,143029
1014098,36422,62463,45172,64793,208850
1014099,34052,4933,4418,23536,66939
1014100,25240,62044,51879,45472,184635
1014101,76100,69317,33514,44238,223169
1014102,69563,25362,64391,64582,223898
1014103,52453,41668,36239,67089,197449
1014104,52613,19604,54142,98996,225355
1014105,69685,47996,16083,58873,192637
1014106,15933,25786,22704,90128,154551
1014107,42335,23610,54419,38817,159181
1014108,55884,36360,21687,2823,116754
1014109,5687,95853,71792,32605,205937
1014110,24499,69449,5144,41613,140705
1014111,87284,89790,41352,95771,314197
1014112,88392,6207,62079,94181,250859
1014113,89165,48486,35519,96988,270158
1014114,53016,60575,9097,23592,146280
1014115,147,79382,84092,64234,227855
1014116,23142,54994,3894,5206,87236
1014117,86574,74418,52774,53047,266813
1014118,31543,75323,85969,4698,197533
1014119,61786,12832,63464,60196,198278
1014120,38000,43247,21295,23966,126508
1014121,25308,50032,87267,21995,184602
1014122,57400,99789,45626,52139,254954
1014123,10895,34372,58309,44128,147704
1014124,62735,66161,26622,7230,162748
1014125,77321,45871,65377,63682,252251
1014126,90666,75496,2850,77114,246126
1014127,59847,61824,46650,4249,172570
1014128,97261,70513,38595,21410,227779
1014129,65879,27681,80660,74021,248241
1014130,20678,22067,11007,27645,81397
1014131,99182,46456,76124,51231,272993
1014132,69250,23174,11604,529,104557
1014133,74649,86007,63379,1150,225185
1014134,46614,30016,84055,56529,217214
1014135,7942,77194,21171,26949,133256
1014136,10966,94243,45154,95899,246262
1014137,98600,95889,53750,30353,278592
1014138,50598,20672,14839,41607,127716
1014139,63393,11018,83984,89391,247786
1014140,47457,82004,9282,57177,195920
1014141,80014,21557,14599,94351,210521
1014142,67856,17051,65432,48194,198533
1014143,68496,78959,52327,71753,271535
1014144,73967,61040,48739,21462,205208
1014145,62467,37527,18403,48244,166641
1014146,77974,71670,53238,52770,255652
1014147,60069,30782,10726,59650,161227
1014148,22161,27809,34077,56898,140945
1014149,47133,53806,1245,97765,199949
1014150,75337,58184,12313,2958,148792
1014151,27329,67583,25925,6029,126866
1014152,39918,9045,90347,71925,211235
1014153,97594,52772,66907,31638,248911
1014154,34402,47505,82648,36418,200973
1014155,32146,73153,22992,87179,215470
1014156,97329,90424,31808,66766,286327
1014157,20009,85090,75215,95369,275683
1014158,84903,96542,42607,74234,298286
1014159,38422,22727,27092,27589,115830
1014160,96482,78959,42596,38973,257010
1014161,44738,33634,93240,89971,261583
1014162,34462,56781,93262,5160,189665
1014163,54543,93666,8926,96119,253254
1014164,71478,10356,54129,65746,201709
1014165,41327,23763,19444,19608,104142
1014166,28108,53141,99311,90777,271337
1014167,52587,73275,501,82912,209275
1014168,315,31980,43898,75710,151903
1014169,82642,25190,19090,23134,150056
1014170,82849,70193,7245,88674,248961
1014171,74623,91070,54812,44567,265072
1014172,94353,20700,56695,52184,223932
1014173,82714,55629,27672,86138,252153
1014174,89167,90700,97436,68713,346016
1014175,27801,66057,51679,14337,159874
1014176,42402,80095,84856,45982,253335
1014177,77032,45365,96883,19573,238853
1014178,20140,99381,86435,74909,280865
1014179,76870,60011,55588,7433,199902
1014180,43299,31402,33194,19444,127339
1014181,36822,32705,32767,50540,152834
1014182,64589,82493,46930,96037,290049
1014183,31324,89632,98946,13150,233052
1014184,72441,71099,65329,66700,275569
1014185,31158,82970,50105,75176,239409
1014186,40061,33113,58025,1530,132729
1014187,53702,60292,92158,90099,296251
1014188,50444,70738,32873,5550,159605
1014189,93797,58372,84068,58678,294915
1014190,68286,29605,98625,6290,202806
1014191,83458,34379,24829,60003,202669
1014192,4957,10988,45637,14203,75785
1014193,31666,27518,65831,83545,208560
1014194,76036,45097,16636,86252,224021
1014195,44084,15265,71643,13887,144879
1014196,54507,80874,99786,88754,323921
1014197,66124,17429,42357,68270,194180
1014198,49341,61719,25799,74468,211327
1014199,77024,17456,95968,71320,261768
1014200,26817,70972,33444,23779,155012
1014201,1119,87885,27955,22767,139726
1014202,73420,2246,64686,42106,182458
1014203,44793,98776,30536,6739,180844
1014204,14534,13486,99794,83794,211608
1014205,97050,98771,17382,37930,251133
1014206,70742,4995,60758,32176,168671
1014207,22362,14316,76245,47225,160148
1014208,69424,86084,62455,22500,240463
1014209,28366,55966,57911,32484,174727
1014210,22142,56916,8474,67538,155070
1014211,12776,5512,34548,45281,98117
1014212,23364,88522,98521,70014,280421
1014213,12250,19651,94090,86009,212000
1014214,68371,87330,82610,83156,321467
1014215,44344,334,11089,25307,81074
1014216,53768,49345,49913,35804,188830
1014217,23477,10518,44752,11388,90135
1014218,2021,39106,75859,28998,145984
1014219,98211,18802,62878,27782,207673
1014220,76963,67522,28883,78008,251376
1014221,1762,21052,11018,14990,48822
1014222,63555,49822,15580,12891,141848
1014223,7941,99646,64389,88434,260410
1014224,12955,21860,11001,14645,60461
1014225,19663,45611,20529,69698,155501
1014226,27320,18599,20064,65116,131099
1014227,247,35338,72321,58064,165970
1014228,18453,22944,13442,26815,81654
1014229,24464,82049,75143,89357,271013
1014230,15404,5437,54723,66920,142484
1014231,28581,2646,46509,73285,151021
1014232,67890,50014,41428,34513,193845
1014233,73102,80902,43496,41850,239350
1014234,15355,86355,34063,87277,223050
1014235,26706,72504,48105,31809,179124
1014236,22582,56001,20645,94479,193707
1014237,46382,53203,53495,33015,186095
1014238,19979,15841,38493,15703,90016
1014239,63501,8742,89198,19412,180853
1014240,21821,93203,14267,14131,143422
1014241,14942,62171,29597,86876,193586
1014242,90772,4570,70593,96729,262664
1014243,41547,33231,11173,34935,120886
1014244,61565,26846,59777,50234,198422
1014245,58601,59913,63802,90877,273193
1014246,18841,22079,70010,84544,195474
1014247,35248,52455,6863,71132,165698
1014248,33093,7540,1948,53617,96198
1014249,76985,64039,48996,98706,288726
1014250,60730,79516,15138,45433,200817
1014251,13674,43335,6157,2402,65568
1014252,72321,32878,18521,15767,139487
1014253,34774,33097,61025,77006,205902
1014254,9282,81481,30764,26519,148046
1014255,60099,65815,68113,50856,244883
1014256,98417,96475,60115,41999,297006
1014257,55141,64532,68235,52033,239941
1014258,37562,19493,64510,30769,152334
1014259,46198,26691,62648,62192,197729
1014260,7976,57266,67447,46733,179422
1014261,71010,69862,50792,97071,288735
1014262,61155,3773,87141,42660,194729
1014263,52364,94632,43938,53045,243979
1014264,64774,64452,40369,32376,201971
1014265,52214,70307,71368,49053,242942
1014266,77841,11827,49172,54280,193120
1014267,54542,52516,95969,75868,278895
1014268,85574,34748,86543,87817,294682
1014269,84121,69739,8356,31540,193756
1014270,6386,70064,81754,82853,241057
1014271,20105,10305,80027,41314,151751
1014272,57115,84664,7567,87759,237105
1014273,67076,59640,85101,76818,288635
1014274,3630,97554,43731,72471,217386
1014275,7869,51548,93695,87894,241006
1014276,74453,39819,19318,42824,176414
1014277,5942,67524,67137,82013,222616
1014278,40162,88265,53500,5516,187443
1014279,46027,79414,2826,8063,136330
1014280,40845,60431,54269,35017,190562
1014281,47402,33761,15027,26200,122390
1014282,7241,29467,74500,66992,178200
1014283,11903,69910,7598,9608,99019
1014284,35415,94300,13591,37286,180592
1014285,2913,31122,4914,97081,136030
1014286,19957,66073,31356,43062,160448
1014287,17610,26968,45808,70672,161058
1014288,68994,7950,49550,76206,202700
1014289,85971,57767,2774,82890,229402
1014290,51061,84175,15298,15176,165710
1014291,49622,6252,32823,35412,124109
1014292,59188,72610,44241,91512,267551
1014293,87241,56116,62800,4416,210573
1014294,54947,91394,21059,87153,254553
1014295,18801,68163,58195,87556,232715
1014296,83879,71916,18399,31839,206033
1014297,44938,59021,51765,7510,163234
1014298,79281,4531,80720,96320,260852
1014299,60342,64546,3696,20797,149381
1014300,98763,17130,53054,63180,232127
1014301,16201,6859,14570,49709,87339
1014302,88416,19019,75140,10599,193174
1014303,38476,92374,80310,86965,298125
1014304,95446,63771,24010,64144,247371
1014305,93401,94026,52464,12660,252551
1014306,59772,53610,12698,51272,177352
1014307,65322,44221,19768,67492,196803
1014308,5290,63226,45585,70612,184713
1014309,83349,59509,49989,15766,208613
1014310,44437,82579,83386,20291,230693
1014311,97831,19590,8396,23816,149633
1014312,19507,96170,44401,6258,166336
1014313,56798,83222,23152,74497,237669
1014314,15510,8363,60165,74363,158401
1014315,18023,27107,40373,31231,116734
1014316,74113,97021,38427,40571,250132
1014317,47701,91623,41357,83041,263722
1014318,33002,99772,28116,25739,186629
1014319,40387,18822,58931,70742,188882
1014320,90998,17099,18861,8504,135462
1014321,18874,7470,86046,98174,210564
1014322,93164,41800,59193,1019,195176
1014323,7912,36477,83267,25577,153233
1014324,74196,22259,32431,10219,139105
1014325,96527,68945,80482,96356,342310
1014326,52165,61474,23125,20055,156819
1014327,33936,96194,33003,86844,249977
1014328,5679,1765,40570,45990,94004
1014329,84472,12388,16496,11001,124357
1014330,67626,41418,74918,72800,256762
1014331,2101,2507,71134,71287,147029
1014332,57321,65065,94959,75278,292623
1014333,86200,35590,17900,91941,231631
1014334,18111,25662,52257,8502,104532
1014335,98842,57561,88320,54444,299167
1014336,12368,59197,97458,3852,172875
1014337,73326,52116,1150,93201,219793
1014338,76729,95119,46628,52410,270886
1014339,97762,65597,15948,43482,222789
1014340,40474,35715,24906,42484,143579
1014341,45840,22098,52194,10212,130344
1014342,17158,73792,90438,67121,248509
1014343,73695,55034,77733,6246,212708
1014344,71704,23908,51538,82193,229343
1014345,47154,52769,19920,72992,192835
1014346,9042,85236,50862,93987,239127
1014347,35563,21967,58587,53407,169524
1014348,60792,74502,77702,20202,233198
1014349,66512,57809,75529,28747,228597
1014350,48516,90197,81625,29061,249399
1014351,4441,95102,64585,18907,183035
1014352,53806,48702,68123,77827,248458
1014353,76331,91688,93527,14584,276130
1014354,37092,64393,52488,74741,228714
1014355,40641,22845,24847,24462,112795
1014356,71685,81525,51273,46363,250846
1014357,35948,75727,16366,24880,152921
1014358,16720,3279,83119,67867,170985
1014359,65098,34365,73552,3621,176636
1014360,30411,82846,70723,64288,248268
1014361,55678,21554,23610,73195,174037
1014362,43248,1175,40661,47801,132885
1014363,85309,22396,85264,83209,276178
1014364,35208,69244,34440,31899,170791
1014365,93689,79563,76108,25539,274899
1014366,20779,7358,97433,468,126038
1014367,11239,78815,40497,97536,228087
1014368,31429,46566,36409,35754,150158
1014369,78791,39977,97570,69324,285662
1014370,26537,91256,47809,60899,226501
1014371,65287,82370,84635,29460,261752
1014372,70375,33527,53441,49092,206435
1014373,69339,73009,53101,20378,215827
1014374,93390,82810,91103,1867,269170
1014375,42728,23464,14254,40631,121077
1014376,50350,49425,31209,79069,210053
1014377,88226,7137,3997,59079,158439
1014378,69073,88069,29834,33659,220635
1014379,78542,93650,32094,48138,252424
1014380,94497,31270,84132,4952,214851
1014381,22648,19543,97456,37725,177372
1014382,10727,89790,29600,22106,152223
1014383,74053,75124,72575,42874,264626
1014384,26958,6122,1617,5434,40131
1014385,43942,48583,68208,64421,225154
1014386,67668,50348,90666,74016,282698
1014387,40779,45442,23139,28974,138334
1014388,42976,78507,97545,14000,233028
1014389,28032,82570,32933,78378,221913
1014390,49377,44655,20237,25325,139594
1014391,20332,22826,88829,99488,231475
1014392,43576,46277,46464,48709,185026
1014393,64880,10627,83158,29578,188243
1014394,59924,91653,73859,81988,307424
1014395,72552,19871,1688,78404,172515
1014396,81843,17898,43924,10228,153893
1014397,13250,17031,27154,97267,154702
1014398,13978,30846,96912,60652,202388
1014399,6256,98211,45600,10711,160778
1014400,20786,67720,52764,74489,215759
1014401,33145,51282,64657,53952,203036
1014402,39263,4596,15779,20616,80254
1014403,20030,56105,81396,98743,256274
1014404,53514,66047,62536,87770,269867
1014405,92795,81558,53470,38502,266325
1014406,5706,87913,24315,35051,152985
1014407,82467,88699,64946,77742,313854
1014408,20296,92287,92632,67575,272790
1014409,79025,60764,40270,84400,264459
1014410,51800,36830,56864,26426,171920
1014411,58976,23599,48978,16317,147870
1014412,46034,4109,89628,93449,233220
1014413,52264,90656,21465,54167,218552
1014414,99490,52266,78097,36049,265902
1014415,13540,56928,32847,57327,160642
1014416,69758,40943,91811,7875,210387
1014417,44062,81971,33468,25438,184939
1014418,85595,47253,72129,15380,220357
1014419,35724,73728,67857,69934,247243
1014420,74245,26406,45841,56165,202657
1014421,81645,17021,69874,4360,172900
1014422,70471,19724,82473,4886,177554
1014423,27258,10845,42192,41095,121390
1014424,10014,71061,12984,1912,95971
1014425,531,52935,98677,16296,168439
1014426,86858,41070,25473,70407,223808
1014427,31539,46087,67251,31130,176007
1014428,41694,27894,22324,26993,118905
1014429,49300,71774,20189,55547,196810
1014430,19170,74645,81810,25011,200636
1014431,7735,81087,29925,98734,217481
1014432,11064,98982,5757,62983,178786
1014433,69639,94293,89855,93379,347166
1014434,40684,63723,56762,29760,190929
1014435,54974,77189,69747,14901,216811
1014436,52361,9974,94034,48854,205223
1014437,94435,55638,48112,73848,272033
1014438,63783,20601,15562,89097,189043
1014439,5112,12932,65545,56819,140408
1014440,6449,87470,59122,46382,199423
1014441,69592,15786,81817,6120,173315
1014442,55043,90116,42522,98051,285732
1014443,68300,58878,63710,15962,206850
1014444,19242,6063,38535,89738,153578
1014445,31878,33130,6412,88642,160062
1014446,23147,30876,86421,43929,184373
1014447,41474,80284,5265,96590,223613
1014448,8709,89533,58421,24961,181624
1014449,4643,66988,91562,65986,229179
1014450,95398,15322,28821,53876,193417
1014451,65773,96734,78650,41221,282378
1014452,60651,12209,85010,65830,223700
1014453,68980,92113,36749,21763,219605
1014454,1679,3037,48463,32935,86114
1014455,39636,19899,2318,42804,104657
1014456,39414,53383,67840,87529,248166
1014457,59328,35131,11073,58977,164509
1014458,74539,82611,64387,6179,227716
1014459,21823,8619,7863,45775,84080
1014460,10605,90861,6356,57006,164828
1014461,8793,86621,89130,89088,273632
1014462,20185,64117,51677,15382,151361
1014463,23943,54072,98014,88140,264169
1014464,54234,89180,38052,41655,223121
1014465,9718,94747,60539,46398,211402
1014466,67054,10138,72354,21029,170575
1014467,52695,51173,54077,65453,223398
1014468,29976,90827,63618,62083,246504
1014469,74757,38294,92087,300,205438
1014470,57926,24298,34311,55088,171623
1014471,48442,98614,35292,96698,279046
1014472,57833,42350,31832,65872,197887
1014473,61856,43304,90124,65235,260519
1014474,50837,37926,55226,34816,178805
1014475,71867,41021,90271,46190,249349
1014476,52076,19,70081,19060,141236
1014477,1363,33654,82317,46496,163830
1014478,36693,79240,20519,24409,160861
1014479,11793,73970,65474,41748,192985
1014480,98124,53630,4700,95583,252037
1014481,21610,96377,11309,66983,196279
1014482,36229,70717,272,84283,191501
1014483,65350,427,45804,21441,133022
1014484,12387,20495,63533,41686,138101
1014485,7181,40943,68681,52795,169600
1014486,16614,34566,56477,81803,189460
1014487,53576,49368,23057,48080,174081
1014488,88233,98491,76204,41030,303958
1014489,75117,31841,27665,83257,217880
1014490,43001,6592,7735,79357,136685
1014491,85580,61299,82260,30656,259795
1014492,26650,58750,68504,63640,217544
1014493,22768,63160,42477,77908,206313
1014494,37039,72222,58419,17694,185374
1014495,41684,32208,46084,93002,212978
1014496,1957,19288,17803,76348,115396
1014497,11345,2769,53838,44405,112357
1014498,47027,77426,76644,36553,237650
1014499,58690,22290,12324,32515,125819
1014500,55754,43767,48142,94688,242351
1014501,31155,2898,36571,36195,106819
1014502,57541,84414,57640,39954,239549
1014503,86455,64043,86201,91053,327752
1014504,76218,50352,72714,48400,247684
1014505,29770,39866,99146,41064,209846
1014506,92287,27853,84231,37123,241494
1014507,41625,94398,81341,1661,219025
1014508,16496,48309,96912,4428,166145
1014509,78971,88021,91849,69736,328577
1014510,53244,81220,71439,20579,226482
1014511,37715,90948,43945,98627,271235
1014512,47608,26705,93104,69614,237031
1014513,63091,16112,79758,33745,192706
1014514,83562,68225,38252,82401,272440
1014515,91892,91711,49537,98687,331827
1014516,83468,86945,30816,56748,257977
1014517,9064,55107,75141,36982,176294
1014518,44638,45044,89488,83656,262826
1014519,54323,69438,73570,73190,270521
1014520,10272,56871,28629,34748,130520
1014521,44869,51464,63485,94969,254787
1014522,36427,66108,32125,5460,140120
1014523,10821,12711,96212,30799,150543
1014524,84551,64116,89381,3534,241582
1014525,1993,27476,85256,99867,214592
1014526,18041,96577,94864,19802,229284
1014527,30539,59421,25222,91769,206951
1014528,49454,83168,85815,58987,277424
1014529,51650,93599,61835,46689,253773
1014530,10521,11962,39583,31503,93569
1014531,79737,77951,93830,9993,261511
1014532,29238,63347,38663,73805,205053
1014533,155,7052,16239,15133,38579
1014534,91965,69570,77494,54197,293226
1014535,37848,27794,9309,77866,152817
1014536,44484,51239,49273,73924,218920
1014537,73058,24595,78349,44485,220487
1014538,3839,67239,56339,57844,185261
1014539,59234,77936,28394,54944,220508
1014540,63161,44978,24495,97841,230475
1014541,8807,75644,21119,53039,158609
1014542,66381,7709,72631,13026,159747
1014543,77153,98020,55620,74822,305615
1014544,79722,41282,86293,89119,296416
1014545,4737,40260,5370,6971,57338
1014546,98806,97836,17885,84339,298866
1014547,96738,57922,89979,97472,342111
1014548,32945,92059,18195,30984,174183
1014549,5205,2329,82738,40749,131021
1014550,94813,90003,38531,69544,292891
1014551,74668,70177,12048,96056,252949
1014552,10067,52963,20467,34223,117720
1014553,98065,87255,28237,29194,242751
1014554,25522,6895,99587,88546,220550
1014555,28624,75385,7623,39865,151497
1014556,21762,78994,85512,58939,245207
1014557,15163,12949,89417,56551,174080
1014558,23213,46540,51417,43790,164960
1014559,86267,12196,18496,55092,172051
1014560,84840,99809,919,69338,254906
1014561,54034,13760,64014,42568,174376
1014562,92696,35140,4586,43802,176224
1014563,70129,61777,93650,51841,277397
1014564,55811,85309,21730,90293,253143
1014565,12760,55137,36986,14570,119453
1014566,51379,68606,34902,35627,190514
1014567,73949,37142,5403,56416,172910
1014568,52440,63457,34642,18091,168630
1014569,36665,33549,89550,90243,250007
1014570,13902,65788,7751,45810,133251
1014571,68406,50745,4271,6465,129887
1014572,31926,97297,43256,39436,211915
1014573,34113,4150,67827,15936,122026
1014574,39149,66103,72910,60896,239058
1014575,31170,33230,54390,51560,170350
1014576,53412,12497,11371,93560,170840
1014577,31938,73302,3360,11766,120366
1014578,20467,16648,52446,43976,133537
1014579,81715,66329,73967,98983,320994
1014580,65903,45044,57445,60716,229108
1014581,89806,41191,55643,19959,206599
1014582,79923,31035,1631,61344,173933
1014583,86927,95697,71818,51461,305903
1014584,7688,42315,53696,76739,180438
1014585,8274,64569,44939,15365,133147
1014586,66678,21306,14303,29670,131957
1014587,59488,65519,41682,17698,184387
1014588,39770,68171,6621,19117,133679
1014589,66744,59609,7405,31436,165194
1014590,24777,38760,73137,85279,221953
1014591,65273,48969,97790,21497,233529
1014592,28640,38699,16157,72242,155738
1014593,17989,99846,46760,99155,263750
1014594,87564,34705,53203,41877,217349
1014595,41776,38748,36299,52139,168962
1014596,14456,58330,95075,65409,233270
1014597,68243,25853,9952,30118,134166
1014598,47720,48372,72051,50068,218211
1014599,84279,97816,73808,57128,313031
1014600,38859,17335,57524,11579,125297
1014601,33331,96575,69673,58847,258426
1014602,240,80322,27846,6277,114685
1014603,44249,71361,24617,71723,211950
1014604,90623,90559,45492,63770,290444
1014605,97538,61070,87130,90672,336410
1014606,69572,43116,4219,27042,143949
1014607,94921,35466,10426,2826,143639
1014608,36180,51914,11841,33523,133458
1014609,74782,61822,34983,65370,236957
1014610,73485,96595,55485,88375,313940
1014611,75007,65884,22733,91467,255091
1014612,57869,70371,82691,74717,285648
1014613,84874,37676,30381,40996,193927
1014614,6799,8382,79845,50458,145484
1014615,65082,18125,72493,50097,205797
1014616,94350,86955,48151,38899,268355
1014617,79301,13198,17849,6265,116613
1014618,85492,82689,3021,87279,258481
1014619,11275,2286,14415,9881,37857
1014620,35885,72214,33779,79224,221102
1014621,99712,17717,4972,56799,179200
1014622,9429,66643,26963,66220,169255
1014623,35328,4343,11137,33810,84618
1014624,92081,81386,63517,10302,247286
1014625,91349,22711,58341,9974,182375
1014626,23027,7756,85630,99801,216214
1014627,84612,77534,19167,82691,264004
1014628,38734,15745,87717,97367,239563
1014629,798,67485,795,98804,167882
1014630,2106,79714,12464,69847,164131
1014631,87430,65117,51657,18829,223033
1014632,425,71849,53120,33903,159297
1014633,86705,10348,39570,41787,178410
1014634,33558,60545,29059,72559,195721
1014635,17477,32818,16106,31100,97501
1014636,89332,33668,22576,4724,150300
1014637,82701,25413,71750,4670,184534
1014638,73424,34061,5395,9776,122656
1014639,5692,57883,47224,79586,190385
1014640,63185,27061,67327,75671,233244
1014641,1004,65147,90115,11436,167702
1014642,87182,5235,38731,90126,221274
1014643,10491,66260,92787,27341,196879
1014644,64713,21060,24094,19256,129123
1014645,97336,78888,82918,62366,321508
1014646,75119,12102,43143,45714,176078
1014647,90169,80680,98369,56089,325307
1014648,30355,96375,22246,68087,217063
1014649,46029,78476,65733,80953,271191
1014650,39386,1206,5459,57351,103402
1014651,39674,11237,1216,24970,77097
1014652,11655,27220,51987,21423,112285
1014653,51352,98686,28463,83950,262451
1014654,55817,91086,96477,73453,316833
1014655,75072,63075,81821,17573,237541
1014656,27505,41909,5342,22379,97135
1014657,29688,71197,4197,65707,170789
1014658,67155,58412,12196,94519,232282
1014659,36475,17107,50354,17156,121092
1014660,38718,38442,360,90818,168338
1014661,34533,37802,54301,36803,163439
1014662,76933,57162,64581,67640,266316
1014663,64951,56440,41706,37251,200348
1014664,95139,41776,25072,99813,261800
1014665,66634,8072,55175,76397,206278
1014666,5955,5102,12537,56504,80098
1014667,39182,71997,3915,77357,192451
1014668,96349,46452,86539,82028,311368
1014669,87362,88969,56236,80441,313008
1014670,31693,77654,46320,51049,206716
1014671,54868,20526,56982,54598,186974
1014672,17010,30966,50181,2198,100355
1014673,52851,11645,69651,36103,170250
1014674,64136,54881,51482,76002,246501
1014675,99314,54321,9462,18696,181793
1014676,55755,6169,97263,99902,259089
1014677,34903,28616,78776,1114,143409
1014678,94046,28391,46195,37283,205915
1014679,3100,42526,21728,26167,93521
1014680,75300,1197,49266,53636,179399
1014681,59363,82603,44957,51698,238621
1014682,64651,76075,3642,42632,187000
1014683,34048,73661,62641,78615,248965
1014684,58482,58438,96092,51035,264047
1014685,51517,82242,80636,48997,263392
1014686,25468,99587,89230,55744,270029
1014687,51032,21931,80730,80188,233881
1014688,66442,22865,46201,40281,175789
1014689,18284,55793,70905,5286,150268
1014690,14001,29563,27143,16858,87565
1014691,20943,94921,4708,32923,153495
1014692,17826,53661,76474,19497,167458
1014693,92794,53314,83230,81366,310704
1014694,80801,45682,51863,76127,254473
1014695,13967,69870,11131,83639,178607
1014696,57174,53918,24891,8729,144712
1014697,63775,3509,86946,2203,156433
1014698,85787,78504,66950,30797,262038
1014699,78485,58324,98891,59434,295134
1014700,49118,67018,68355,99619,284110
1014701,8239,16878,52179,94138,171434
1014702,67742,7233,20029,43639,138643
1014703,1755,23988,41040,44365,111148
1014704,6273,25842,13637,82935,128687
1014705,17075,52415,14410,89343,173243
1014706,94924,26135,57496,31229,209784
1014707,34962,28939,37820,59471,161192
1014708,48360,17451,48104,94552,208467
1014709,69230,39469,92087,85134,285920
1014710,23621,84915,73676,81351,263563
1014711,65457,93278,27302,91691,277728
1014712,74340,73893,81552,39452,269237
1014713,289,20810,3803,47632,72534
1014714,22541,52729,82076,7765,165111
1014715,47146,83318,64213,76541,271218
1014716,58525,84211,827,39937,183500
1014717,64288,99912,10540,50417,225157
1014718,61162,16538,45058,62620,185378
1014719,27511,1770,53627,58998,141906
1014720,7000,1570,23196,96743,128509
1014721,63278,20299,44195,83085,210857
1014722,26323,45761,31318,42319,145721
1014723,18295,67375,30769,49739,166178
1014724,74787,57522,73501,95115,300925
1014725,12799,50150,91569,80987,235505
1014726,27142,54272,55368,88638,225420
1014727,53444,73923,21068,34747,183182
1014728,9618,11340,75438,27822,124218
1014729,57109,30812,73312,80054,241287
1014730,11202,46187,94126,46304,197819
1014731,90710,92657,11003,72605,266975
1014732,99907,32084,31841,48149,211981
1014733,10078,64183,13408,62220,149889
1014734,4916,20000,83203,83493,191612
1014735,96350,48890,39086,88806,273132
1014736,38361,89883,33319,12286,173849
1014737,57060,40081,91224,32373,220738
1014738,23055,97608,22657,83263,226583
1014739,37362,56297,89699,75047,258405
1014740,90707,85210,98839,88108,362864
1014741,63278,72296,20259,91484,247317
1014742,13053,92711,22119,64740,192623
1014743,7773,45186,86005,55062,194026
1014744,57426,40833,11662,17034,126955
1014745,14791,2640,37163,53906,108500
1014746,24368,93799,76693,52241,247101
1014747,32959,90554,77363,87713,288589
1014748,847,77109,62485,4822,145263
1014749,46468,70614,1484,18157,136723
1014750,861,63484,78309,7578,150232
1014751,56895,50823,58591,874,167183
1014752,39906,62191,90194,14592,206883
1014753,82498,87674,62322,50977,283471
1014754,76790,74879,2337,359,154365
1014755,9882,71458,45640,76370,203350
1014756,40914,62067,923,31034,134938
1014757,39328,26087,8960,97929,172304
1014758,52191,18658,95880,91186,257915
1014759,91751,16914,62515,21115,192295
1014760,97734,34036,82169,78102,292041
1014761,51020,24167,7174,3872,86233
1014762,86313,94055,89183,37664,307215
1014763,28248,56853,60713,31591,177405
1014764,87590,90495,5294,46678,230057
1014765,39491,83610,7962,82903,213966
1014766,60345,71909,37408,1433,171095
1014767,68724,15236,38830,9660,132450
1014768,51612,32497,96306,67169,247584
1014769,37381,14808,74931,76903,204023
1014770,89106,91114,41734,8545,230499
1014771,87544,29639,13716,64988,195887
1014772,55699,80882,84507,70921,292009
1014773,23276,43076,21891,37977,126220
1014774,23944,45879,11695,40892,122410
1014775,53587,5864,49353,36706,145510
1014776,86088,72386,670,42130,201274
1014777,53686,29191,6298,77055,166230
1014778,43872,70163,92801,11978,218814
1014779,95674,74710,67907,98301,336592
1014780,29644,62128,9740,97475,198987
1014781,79710,13892,91260,18751,203613
1014782,83703,21449,95326,52801,253279
1014783,87763,5482,59622,88964,241831
1014784,9740,52914,92011,98405,253070
1014785,30853,21592,52665,38862,143972
1014786,88516,71819,42917,61319,264571
1014787,95371,59448,16693,24303,195815
1014788,41015,42235,54348,93058,230656
1014789,59126,95950,44515,86779,286370
1014790,85384,56701,63201,15853,221139
1014791,57129,20144,40563,20946,138782
1014792,55503,98080,84196,6992,244771
1014793,83815,27043,92162,38746,241766
1014794,38485,20999,64509,84216,208209
1014795,41501,75932,89492,43925,250850
1014796,95586,3973,93818,42597,235974
1014797,92294,65799,32258,16732,207083
1014798,87936,28920,34355,82502,233713
1014799,38435,58623,78371,85855,261284
1014800,12094,21151,88060,29442,150747
1014801,40048,15077,90771,8409,154305
1014802,77649,68547,40537,33362,220095
1014803,5978,90371,65584,99622,261555
1014804,33541,77422,90732,55654,257349
1014805,34730,52758,74524,27566,189578
1014806,10180,2172,1327,28478,42157
1014807,50384,27196,20743,48093,146416
1014808,32706,62555,16964,13178,125403
1014809,98954,4887,83588,43297,230726
1014810,63707,79870,24182,49062,216821
1014811,51111,49003,22528,15596,138238
1014812,99639,58228,82691,48219,288777
1014813,40101,58835,59066,27803,185805
1014814,88355,96223,5082,31618,221278
1014815,41135,51591,85526,50758,229010
1014816,8054,76755,23237,28393,136439
1014817,87090,36377,63645,1986,189098
1014818,82831,61013,9953,37360,191157
1014819,36329,50784,73823,52411,213347
1014820,17395,98693,70403,76812,263303
1014821,68841,22523,72350,28666,192380
1014822,38861,30813,12847,2923,85444
1014823,78647,23821,51907,23007,177382
1014824,68342,15306,38599,78315,200562
1014825,50775,35397,40019,62308,188499
1014826,61497,23014,34371,3746,122628
1014827,11105,54786,13151,23083,102125
1014828,65077,93987,13676,67351,240091
1014829,6122,36488,9591,21738,73939
1014830,12463,73169,53457,94235,233324
1014831,32002,57924,2679,63557,156162
1014832,56567,24058,18835,26833,126293
1014833,97444,54535,56049,99477,307505
1014834,30323,58394,51599,76941,217257
1014835,27033,66450,43752,42188,179423
1014836,58010,96532,78434,81450,314426
1014837,95431,89791,29233,84931,299386
1014838,93892,91970,25415,43512,254789
1014839,34534,34538,34872,54112,158056
1014840,67016,80802,82721,12281,242820
1014841,62553,56921,34780,39944,194198
1014842,53898,27242,70808,66740,218688
1014843,22578,15354,60176,87000,185108
1014844,89608,46604,4400,67937,208549
1014845,18984,3178,27892,60760,110814
1014846,43820,15448,99463,18615,177346
1014847,65626,71765,66056,68098,271545
1014848,53391,83807,46699,76065,259962
1014849,33961,3892,6989,62179,107021
1014850,28688,20568,15385,3028,67669
1014851,11789,10088,91948,35095,148920
1014852,16678,71985,38468,63374,190505
1014853,46524,42501,4011,97486,190522
1014854,75070,36309,97151,38602,247132
1014855,75269,18786,42286,56493,192834
1014856,12595,63356,9423,77811,163185
1014857,19720,27687,66545,58679,172631
1014858,18157,50952,50593,81392,201094
1014859,4691,58275,66900,19747,149613
1014860,55888,14394,15065,32793,118140
1014861,3638,48001,52119,31973,135731
1014862,41653,49679,62649,71814,225795
1014863,66139,11010,70801,68407,216357
1014864,89468,16361,2416,29451,137696
1014865,10845,14985,57678,37049,120557
1014866,86695,77628,2291,62935,229549
1014867,94591,60890,36082,81384,272947
1014868,11939,98077,84493,1324,195833
1014869,17285,42061,10500,6740,76586
1014870,24670,47620,19555,73376,165221
1014871,51109,75444,55200,86131,267884
1014872,88692,33145,72712,63380,257929
1014873,17928,40267,27501,38831,124527
1014874,6998,97446,20057,46933,171434
1014875,52600,45877,67341,84902,250720
1014876,78068,62327,12321,65347,218063
1014877,96208,91803,37136,93130,318277
1014878,8845,94747,57012,18182,178786
1014879,7231,3405,2595,42076,55307
1014880,18632,57670,67228,5069,148599
1014881,6692,30332,47544,57499,142067
1014882,80545,10663,16188,64120,171516
1014883,2074,57434,36707,94540,190755
1014884,83745,69624,43498,50648,247515
1014885,95352,38608,14287,3422,151669
1014886,42057,79895,99043,45054,266049
1014887,63297,51369,69198,43917,227781
1014888,53472,84184,91995,66858,296509
1014889,61676,40649,3909,95077,201311
1014890,40572,9880,81427,99978,231857
1014891,32883,50728,57377,97902,238890
1014892,56734,14929,49487,90161,211311
1014893,54835,74594,5730,2195,137354
1014894,47772,76566,14018,62285,200641
1014895,46759,28474,77066,66970,219269
1014896,1315,68013,49889,15729,134946
1014897,75450,92126,55571,52615,275762
1014898,74091,93788,13366,58288,239533
1014899,28856,91497,73364,96971,290688
1014900,28245,22502,74737,24386,149870
1014901,43362,76103,25491,88097,233053
1014902,85532,77288,28541,86891,278252
1014903,2064,19912,58827,4346,85149
1014904,68512,22543,70502,17405,178962
1014905,37536,644,77388,3526,119094
1014906,75000,56417,9550,46572,187539
1014907,27710,9139,56603,78068,171520
1014908,49447,20844,56485,89968,216744
1014909,74052,9724,73242,20176,177194
1014910,76278,36860,88234,33209,234581
1014911,51536,23625,75607,5728,156496
1014912,10443,83338,35951,15018,144750
1014913,91120,59172,22616,68775,241683
1014914,54275,87637,4376,87491,233779
1014915,15798,15607,29638,53470,114513
1014916,12343,15211,40971,84599,153124
1014917,82340,8055,23051,22492,135938
1014918,86985,56937,4253,36846,185021
1014919,52682,14307,24854,70060,161903
1014920,29388,38815,77536,1019,146758
1014921,98869,16816,91237,56679,263601
1014922,95100,61154,92302,95283,343839
1014923,51356,2412,91567,20459,165794
1014924,38290,15252,33082,83625,170249
1014925,4604,26075,25757,63671,120107
1014926,31588,78223,9278,40413,159502
1014927,97911,99986,47235,17007,262139
1014928,16360,21823,80270,87684,206137
1014929,86675,33380,67322,73321,260698
1014930,25556,99443,44503,91545,261047
1014931,13860,35376,86186,79591,215013
1014932,84949,30079,81197,9278,205503
1014933,48233,60789,88761,32925,230708
1014934,18418,23752,59125,30191,131486
1014935,97349,80087,12421,87393,277250
1014936,79392,80842,24701,17392,202327
1014937,17516,67803,74797,91937,252053
1014938,13343,54964,64130,45969,178406
1014939,14070,55841,19416,52460,141787
1014940,77599,13765,259,97331,188954
1014941,15595,40811,69982,91231,217619
1014942,47150,70478,2074,88390,208092
1014943,41859,59805,5851,99430,206945
1014944,63517,65292,79356,58799,266964
1014945,23,89839,24689,463,115014
1014946,96477,42880,58365,46191,243913
1014947,69740,60939,95250,5994,231923
1014948,11355,68763,49993,46378,176489
1014949,55048,453,5933,49947,111381
1014950,57723,51428,6897,87025,203073
1014951,64123,74628,79450,77176,295377
1014952,77124,87625,22811,69304,256864
1014953,64874,38796,82790,96454,282914
1014954,22429,67602,32366,28159,150556
1014955,82315,68457,2348,60485,213605
1014956,96061,42266,58087,43871,240285
1014957,29292,65337,18264,90548,203441
1014958,27499,59206,95948,2920,185573
1014959,39591,74884,40052,80955,235482
1014960,51599,78045,87829,83343,300816
1014961,24967,27875,38989,71044,162875
1014962,19177,59121,35410,24480,138188
1014963,82025,17384,85332,24722,209463
1014964,45504,94060,77495,85115,302174
1014965,82034,59885,54955,25683,222557
1014966,6205,98014,66893,78210,249322
1014967,34022,5741,72414,32536,144713
1014968,64172,69926,41273,73094,248465
1014969,61351,5740,87222,93484,247797
1014970,91382,64530,74390,82196,312498
1014971,27268,59524,24631,74563,185986
1014972,72377,71747,27959,99272,271355
1014973,75005,97662,59663,2005,234335
1014974,63033,65468,41965,9960,180426
1014975,3757,63875,42839,95511,205982
1014976,12174,23410,42134,12142,89860
1014977,44621,75944,31425,20493,172483
1014978,63236,96817,38488,76076,274617
1014979,595,25406,13313,69185,108499
1014980,23452,26376,91115,1374,142317
1014981,20686,95010,23711,84071,223478
1014982,32854,8062,62120,47790,150826
1014983,98369,18819,69534,30883,217605
1014984,39376,94008,46653,16027,196064
1014985,18917,60473,98136,54490,232016
1014986,55222,22688,42867,14032,134809
1014987,18838,5700,35569,98487,158594
1014988,83480,6008,6826,53046,149360
1014989,7991,350,99180,76547,184068
1014990,69172,2427,35270,23509,130378
1014991,58182,74261,34129,32550,199122
1014992,70655,47595,86854,42040,247144
1014993,57466,30633,97990,18747,204836
1014994,68394,29838,12455,36851,147538
1014995,87118,35160,86888,79210,288376
1014996,46317,20499,42210,33861,142887
1014997,6542,3297,25879,30055,65773
1014998,40690,29174,44092,88856,202812
1014999,85515,72975,69217,48341,276048
1015000,98005,82550,52620,62760,295935
1015001,70988,97280,43051,5229,216548
1015002,96376,84087,34969,43815,259247
1015003,35118,98699,17395,5908,157120
1015004,70759,58116,80543,29984,239402
1015005,26726,64790,24581,82310,198407
1015006,70270,1107,16013,95813,183203
1015007,24450,438,26344,78109,129341
1015008,85183,42669,15567,20346,163765
1015009,43160,21462,8563,88219,161404
1015010,5312,91541,13085,59452,169390
1015011,16957,53898,55881,92854,219590
1015012,70920,69315,61667,41779,243681
1015013,50289,67708,54445,97486,269928
1015014,94944,49483,40139,74820,259386
1015015,19055,77928,86839,28546,212368
1015016,38936,36012,50972,11489,137409
1015017,18476,72092,15772,83625,189965
1015018,1046,1946,3593,73070,79655
1015019,25756,77293,27077,35118,165244
1015020,52171,30527,25956,26277,134931
1015021,33889,12606,53061,62699,162255
1015022,46329,50384,86775,89521,273009
1015023,38135,81386,257,75680,195458
1015024,20874,6282,71773,45710,144639
1015025,45444,91882,91125,62685,291136
1015026,34127,716,82298,59991,177132
1015027,4442,45847,3891,65805,119985
1015028,38841,59516,51253,27138,176748
1015029,19090,2066,94776,5683,121615
1015030,39798,67019,48514,79836,235167
1015031,83767,65267,91798,68181,309013
1015032,72360,93979,67318,3290,236947
1015033,13900,9281,97897,60183,181261
1015034,40865,70919,59904,17222,188910
1015035,30824,68057,64053,18521,181455
1015036,54803,23861,48804,76641,204109
1015037,32125,93108,96058,93913,315204
1015038,41378,18625,74364,96358,230725
1015039,2839,66330,16623,63691,149483
1015040,96123,31065,90754,63673,281615
1015041,58546,33001,54593,28833,174973
1015042,53818,44582,69959,8316,176675
1015043,45899,83049,42607,98489,270044
1015044,39351,6256,94247,73092,212946
1015045,66982,96512,11194,26585,201273
1015046,5821,10925,35423,16288,68457
1015047,17094,95943,68205,80737,261979
1015048,84787,12701,80659,12636,190783
1015049,26168,12235,54248,69637,162288
1015050,36756,37423,51373,80696,206248
1015051,76405,60441,51092,56717,244655
1015052,74997,66666,21055,37819,200537
1015053,67189,68569,52124,82225,270107
1015054,82616,17975,83452,95434,279477
1015055,3002,94284,83157,4912,185355
1015056,80371,17456,78874,16681,193382
1015057,27379,49338,57028,52421,186166
1015058,31447,3971,32910,97049,165377
1015059,95979,55184,25809,51392,228364
1015060,85093,91860,9082,47752,233787
1015061,13931,94645,50172,18629,177377
1015062,99387,97970,96569,46771,340697
1015063,78504,33579,57661,50641,220385
1015064,77742,55981,42916,71297,247936
1015065,30658,26198,89274,44816,190946
1015066,39575,51281,82098,33938,206892
1015067,30014,57255,20529,58651,166449
1015068,48379,73207,39250,44379,205215
1015069,16926,15126,5816,20520,58388
1015070,79471,33588,46952,42589,202600
1015071,70696,51153,6377,52979,181205
1015072,20676,51560,30524,52118,154878
1015073,51999,53440,20916,67345,193700
1015074,42761,62462,22706,76305,204234
1015075,72351,93667,49121,40364,255503
1015076,21222,87617,85676,59866,254381
1015077,10683,50668,63834,79489,204674
1015078,81598,96412,36370,78295,292675
1015079,25122,52134,52358,85502,215116
1015080,22616,88381,1177,24294,136468
1015081,52352,68950,35400,15616,172318
1015082,82280,30332,6344,73794,192750
1015083,66656,93467,1211,57017,218351
1015084,86000,41619,81942,32669,242230
1015085,71256,13010,2936,54260,141462
1015086,36522,25174,27849,35574,125119
1015087,55794,83396,83032,93980,316202
1015088,79140,85548,23801,11739,200228
1015089,68101,16962,29770,29912,144745
1015090,45970,19535,43633,11891,121029
1015091,3158,9231,3193,47160,62742
1015092,24441,91138,65953,99999,281531
1015093,75102,78760,18490,36398,208750
1015094,71529,18715,93977,47201,231422
1015095,94333,15267,46798,10564,166962
1015096,29250,41468,19542,8807,99067
1015097,31519,79487,5167,62099,178272
1015098,83591,89318,27139,47572,247620
1015099,92748,17634,5657,90021,206060
1015100,39655,74617,53504,743,168519
1015101,28228,331,18327,91931,138817
1015102,55049,3107,40074,35889,134119
1015103,72957,12190,1690,72276,159113
1015104,64314,54498,9088,91425,219325
1015105,74574,36908,69297,63640,244419
1015106,33044,57591,51187,17652,159474
1015107,20534,91907,7388,6239,126068
1015108,28705,31743,6218,75607,142273
1015109,55088,18365,56472,16896,146821
1015110,62100,19950,42089,94752,218891
1015111,89016,41782,82885,12125,225808
1015112,23743,20235,74048,66668,184694
1015113,90598,24494,91818,47809,254719
1015114,74995,10667,29413,88625,203700
1015115,77803,14165,32589,85753,210310
1015116,32789,13864,57393,54464,158510
1015117,7232,46064,76359,95825,225480
1015118,21196,11683,25102,58881,116862
1015119,88214,44900,13772,5900,152786
1015120,89293,32084,87826,21651,230854
1015121,47136,79953,39756,92855,259700
1015122,69842,74758,60025,98174,302799
1015123,61045,72702,3684,40625,178056
1015124,65368,99462,30735,26366,221931
1015125,84896,30660,65097,32589,213242
1015126,34231,77481,20202,4774,136688
1015127,68837,38016,48984,64335,220172
1015128,31533,54941,13125,54017,153616
1015129,62655,33651,8839,60093,165238
1015130,46856,11386,44238,87328,189808
1015131,53736,42748,47437,20735,164656
1015132,92998,16585,83957,17373,210913
1015133,22882,65826,72538,23469,184715
1015134,93238,17200,69344,33542,213324
1015135,41464,48204,48883,50376,188927
1015136,16103,29441,52938,7828,106310
1015137,27422,93840,77942,88942,288146
1015138,50777,84051,99706,96941,331475
1015139,40491,48436,26287,82379,197593
1015140,22128,79872,41282,10280,153562
1015141,20112,10594,31269,98351,160326
1015142,81325,76840,6332,56261,220758
1015143,66049,36333,31733,19956,154071
1015144,45905,21615,91994,46050,205564
1015145,97715,22713,48628,73292,242348
1015146,84412,53396,21959,17192,176959
1015147,37860,14551,52054,20215,124680
1015148,8868,38201,7425,4875,59369
1015149,41632,1158,36480,85748,165018
1015150,83752,95249,46031,45996,271028
1015151,58924,84955,25964,39108,208951
1015152,24415,80506,11613,67527,184061
1015153,3369,83542,79792,32114,198817
1015154,31981,75308,13383,63654,184326
1015155,64479,92117,43587,12497,212680
1015156,8091,84109,83658,15646,191504
1015157,3781,39154,3937,39426,86298
1015158,22788,71918,23561,488,118755
1015159,27049,63247,70393,42710,203399
1015160,78191,24486,10978,54460,168115
1015161,37748,58509,23072,45547,164876
1015162,88161,92298,56966,56654,294079
1015163,88098,86118,25097,11302,210615
1015164,86086,90772,96226,44458,317542
1015165,25777,60089,86713,70388,242967
1015166,28978,75105,36103,61697,201883
1015167,39785,8953,507,8001,57246
1015168,49135,25443,58170,72618,205366
1015169,56373,78063,68140,62288,264864
1015170,96341,24709,62655,50979,234684
1015171,27050,58262,94978,62764,243054
1015172,88989,71682,74070,4960,239701
1015173,72950,45248,69116,28493,215807
1015174,18854,82306,65762,42431,209353
1015175,83520,79963,56450,40635,260568
1015176,81548,64279,47273,85196,278296
1015177,12616,56419,22685,12915,104635
1015178,14327,14806,77958,84528,191619
1015179,62722,98069,70505,6917,238213
1015180,26116,9364,10699,43309,89488
1015181,88632,46391,48810,83966,267799
1015182,70601,42391,51017,63485,227494
1015183,58040,22359,28874,31847,141120
1015184,59669,63546,860,48840,172915
1015185,10279,8886,13697,45235,78097
1015186,97493,83145,98062,10139,288839
1015187,70607,21021,71857,23656,187141
1015188,86202,73471,74698,32264,266635
1015189,52919,96380,61294,24102,234695
1015190,12544,85355,67998,66892,232789
1015191,72352,51706,78084,20691,222833
1015192,96506,55763,63357,34685,250311
1015193,75041,77693,51462,13688,217884
1015194,5034,29165,22397,2061,58657
1015195,87586,33431,15775,73376,210168
1015196,52034,9266,49663,24009,134972
1015197,45458,96610,55020,18051,215139
1015198,892,19675,36792,5364,62723
1015199,68668,68889,99301,88999,325857
1015200,36077,84030,62848,24356,207311
1015201,86065,13832,57650,73410,230957
1015202,85127,64413,45362,676,195578
1015203,78269,82973,27698,15279,204219
1015204,9597,72865,45052,58714,186228
1015205,98642,16427,21117,34119,170305
1015206,71611,13075,95492,54330,234508
1015207,72688,25369,56960,66754,221771
1015208,14402,13650,64158,29750,121960
1015209,40149,6978,68370,64211,179708
1015210,16198,25097,79269,39439,160003
1015211,24573,52396,85436,26840,189245
1015212,44587,28005,95194,14439,182225
1015213,7575,59559,4599,95187,166920
1015214,45191,18339,99168,18632,181330
1015215,55226,82152,23195,48301,208874
1015216,42131,16358,53577,44544,156610
1015217,78118,7708,14853,98914,199593
1015218,83622,42433,15688,46884,188627
1015219,79630,58237,9966,72647,220480
1015220,8598,88247,25522,35559,157926
1015221,90389,40789,17916,15841,164935
1015222,97912,99288,73223,55459,325882
1015223,64620,62851,33472,2367,163310
1015224,70515,91439,3910,77235,243099
1015225,49647,66798,58326,91289,266060
1015226,22550,19056,50325,38496,130427
1015227,44637,5348,31719,6761,88465
1015228,16719,79446,32311,24466,152942
1015229,58216,77282,12328,18387,166213
1015230,97907,11945,25944,98045,233841
1015231,63752,67953,76386,40849,248940
1015232,9853,20443,85013,76852,192161
1015233,73037,48936,70028,44086,236087
1015234,565,42890,67057,6269,116781
1015235,37420,40863,63483,81938,223704
1015236,69290,35995,74623,32742,212650
1015237,2525,17471,4972,95271,120239
1015238,41757,85823,45454,81024,254058
1015239,69330,25067,86664,56889,237950
1015240,80348,92523,65065,89341,327277
1015241,13198,1732,19028,38329,72287
1015242,67656,14556,38963,89324,210499
1015243,94679,8413,42712,39245,185049
1015244,88844,47147,89920,81134,307045
1015245,3718,35124,54221,30493,123556
1015246,25637,59415,40849,23700,149601
1015247,27514,47053,29700,53410,157677
1015248,13434,95930,59750,39098,208212
1015249,4524,15416,87912,65541,173393
1015250,14002,5801,16920,59277,96000
1015251,76578,38474,31317,5404,151773
1015252,11608,71183,28330,76193,187314
1015253,18420,6895,18167,2817,46299
1015254,81648,96139,41012,21373,240172
1015255,63910,31923,70134,48777,214744
1015256,14150,89640,16482,75583,195855
1015257,30435,44244,50948,89742,215369
1015258,55299,69373,83646,54419,262737
1015259,46135,47926,85176,60966,240203
1015260,58370,43441,51399,57514,210724
1015261,52247,91465,97432,44501,285645
1015262,43943,14429,33779,7679,99830
1015263,30641,40681,62205,3255,136782
1015264,95890,73106,56126,37203,262325
1015265,74467,4858,29540,76071,184936
1015266,61286,91343,22037,57035,231701
1015267,18002,5533,23852,26038,73425
1015268,86154,6539,16094,65510,174297
1015269,21668,21350,68070,16603,127691
1015270,8235,40496,94724,36208,179663
1015271,5321,39830,98795,74535,218481
1015272,87744,25456,39372,93941,246513
1015273,42707,4642,26287,77183,150819
1015274,17633,6905,55400,85057,164995
1015275,40860,99683,35186,24947,200676
1015276,91395,41535,29499,66874,229303
1015277,23485,96280,19069,90795,229629
1015278,86546,86337,22536,29466,224885
1015279,63130,92809,67176,29980,253095
1015280,10673,56868,49821,35511,152873
1015281,77881,26417,49989,69448,223735
1015282,27232,22721,87480,43153,180586
1015283,72222,44933,80895,78863,276913
1015284,76330,39694,6778,68400,191202
1015285,97205,27997,51523,63855,240580
1015286,26438,10739,56404,2772,96353
1015287,72555,92939,3593,74853,243940
1015288,4984,25852,14170,36224,81230
1015289,55105,92477,96157,10223,253962
1015290,75996,72105,70731,92107,310939
1015291,84369,40621,93894,5376,224260
1015292,78347,93300,62276,23693,257616
1015293,50373,89250,97474,82547,319644
1015294,76104,87947,33641,25120,222812
1015295,95157,85794,78838,51456,311245
1015296,59276,68984,26671,28990,183921
1015297,19597,79821,1508,46397,147323
1015298,17025,59663,23921,68256,168865
1015299,41729,40384,11558,63129,156800
1015300,58938,35588,71394,88845,254765
1015301,68326,97330,55702,96112,317470
1015302,14723,97892,6686,38070,157371
1015303,76950,47062,95944,5702,225658
1015304,17686,16256,74652,54406,163000
1015305,56883,18268,78039,17195,170385
1015306,42382,94368,44354,6393,187497
1015307,85739,66307,48124,95313,295483
1015308,16182,9385,47531,67411,140509
1015309,51434,94365,69190,96943,311932
1015310,21267,96314,97218,30347,245146
1015311,69845,92100,53594,44894,260433
1015312,60486,61624,35530,33423,191063
1015313,30994,76892,94387,30406,232679
1015314,5224,23569,5185,77505,111483
1015315,56318,44276,77506,30560,208660
1015316,99893,39753,39565,45841,225052
1015317,47557,84580,28021,45507,205665
1015318,72232,55041,31520,34866,193659
1015319,42099,9471,15095,57893,124558
1015320,42559,44502,45058,87185,219304
1015321,24459,77166,13445,97302,212372
1015322,72890,33983,27402,82823,217098
1015323,13563,97570,3197,70352,184682
1015324,46008,7385,79818,2957,136168
1015325,69862,24613,99386,78989,272850
1015326,57214,98328,94088,96348,345978
1015327,27886,3496,84527,63499,179408
1015328,2198,11319,19399,21088,54004
1015329,85985,19534,9287,19889,134695
1015330,59706,60394,72737,17343,210180
1015331,10301,58851,89802,54152,213106
1015332,69690,7321,67337,48203,192551
1015333,17521,40642,38946,96453,193562
1015334,63787,57187,79484,79305,279763
1015335,7611,20239,89169,50862,167881
1015336,68740,21017,81852,45447,217056
1015337,55478,87407,95783,89265,327933
1015338,93135,76693,82615,21,252464
1015339,42605,77842,22218,53480,196145
1015340,70421,2756,26586,47571,147334
1015341,23955,64577,87615,89544,265691
1015342,62310,1581,15227,63680,142798
1015343,55120,36753,17329,72602,181804
1015344,64790,64925,68718,58057,256490
1015345,55314,52557,21896,2066,131833
1015346,79799,99946,54378,63263,297386
1015347,5944,42172,30345,49283,127744
1015348,21908,11713,89409,84436,207466
1015349,17747,76107,34365,85361,213580
1015350,86911,69492,55089,41136,252628
1015351,98383,85992,27071,68066,279512
1015352,55598,22576,52900,76799,207873
1015353,6982,34135,22596,79906,143619
1015354,12965,95862,74249,80200,263276
1015355,338,80410,99549,24096,204393
1015356,66232,58851,89304,75818,290205
1015357,21646,40556,15901,70366,148469
1015358,44176,76903,2720,42524,166323
1015359,91275,31359,91606,6895,221135
1015360,17204,81890,49714,54936,203744
1015361,95670,78455,34415,64732,273272
1015362,42703,97820,12471,71718,224712
1015363,70217,95906,66671,89066,321860
1015364,95453,47351,93724,73769,310297
1015365,71147,88883,94111,31616,285757
1015366,75293,51929,11187,67871,206280
1015367,61333,48212,70770,98712,279027
1015368,83553,94503,61214,34772,274042
1015369,18399,6175,62487,50645,137706
1015370,10151,8108,26960,4229,49448
1015371,93488,12274,96871,4344,206977
1015372,86398,88688,6339,13326,194751
1015373,31032,43780,94645,44671,214128
1015374,37759,97255,93588,74053,302655
1015375,29337,59181,8444,67965,164927
1015376,53131,37546,65740,98840,255257
1015377,95966,4393,10996,84031,195386
1015378,18110,97935,75868,62784,254697
1015379,60434,55277,72628,91638,279977
1015380,9277,63991,71459,62107,206834
1015381,46558,97929,28318,37127,209932
1015382,24701,1491,67680,46486,140358
1015383,59058,91799,60794,75868,287519
1015384,60756,29559,57338,29700,177353
1015385,90291,69168,98834,49819,308112
1015386,77005,9145,7995,53314,147459
1015387,97623,88405,73571,36468,296067
1015388,63023,65428,65504,94130,288085
1015389,52388,32004,13139,68178,165709
1015390,65235,18166,49501,28829,161731
1015391,7715,7903,82923,5172,103713
1015392,64095,60351,34493,44026,202965
1015393,71915,22790,76117,6241,177063
1015394,87359,17662,50486,25730,181237
1015395,53189,22591,13314,93315,182409
1015396,61903,38101,91070,21692,212766
1015397,67987,27742,88189,40693,224611
1015398,33833,57532,77082,78581,247028
1015399,72819,1594,80294,61208,215915
1015400,98162,90656,64576,61633,315027
1015401,45108,89375,18594,55822,208899
1015402,45875,11,8348,2916,57150
1015403,9081,89653,82651,68418,249803
1015404,16663,80271,35509,70028,202471
1015405,47990,38503,11396,31482,129371
1015406,7179,64894,66535,86450,225058
1015407,22417,52852,1165,61260,137694
1015408,55732,62692,13861,98843,231128
1015409,96371,65631,68033,91260,321295
1015410,52332,6997,82984,29269,171582
1015411,92344,62934,48460,16491,220229
1015412,65445,65681,65757,3867,200750
1015413,78331,21781,8397,66550,175059
1015414,46668,87369,87751,62580,284368
1015415,1626,46395,28509,76676,153206
1015416,8547,47594,11621,50390,118152
1015417,24430,4697,13470,78670,121267
1015418,91333,12341,43302,55916,202892
1015419,44774,35851,35338,77966,193929
1015420,25614,94528,2265,50759,173166
1015421,41997,91777,51097,87890,272761
1015422,39570,98020,82938,67485,288013
1015423,18710,13216,74530,14134,120590
1015424,76323,6712,72783,73191,229009
1015425,39580,78405,63329,62298,243612
1015426,64441,77133,73605,31741,246920
1015427,66228,60498,89827,66732,283285
1015428,27107,53018,34634,70519,185278
1015429,2530,39647,98967,76841,217985
1015430,16989,31563,24660,74359,147571
1015431,12,6475,52636,4834,63957
1015432,79996,41081,88459,66258,275794
1015433,69235,69810,35503,25390,199938
1015434,21499,94365,38350,67231,221445
1015435,33116,62505,36942,40473,173036
1015436,89362,48824,38432,44343,220961
1015437,60463,92133,52511,67494,272601
1015438,89908,19976,90013,77486,277383
1015439,44449,48964,14057,1398,108868
1015440,88426,9187,2134,62170,161917
1015441,67469,56163,76762,19076,219470
1015442,36649,13384,68376,54682,173091
1015443,1663,67088,89412,37098,195261
1015444,43430,73154,73308,68123,258015
1015445,16892,3821,13067,32731,66511
1015446,71316,84531,54775,36352,246974
1015447,94218,55909,94727,4942,249796
1015448,68272,37531,95240,67165,268208
1015449,24436,16305,90226,11355,142322
1015450,92150,26663,92656,16402,227871
1015451,59963,92913,34585,73432,260893
1015452,88338,50718,57248,73672,269976
1015453,71008,93574,53780,35762,254124
1015454,71736,41488,20154,1579,134957
1015455,1178,11269,7315,62680,82442
1015456,90581,80850,8615,23260,203306
1015457,97488,60381,24610,53999,236478
1015458,55412,11950,77839,1509,146710
1015459,59297,25699,26711,2361,114068
1015460,96087,54483,69439,24471,244480
1015461,35140,34197,83496,90857,243690
1015462,1033,15936,9270,14098,40337
1015463,83784,22473,22036,72939,201232
1015464,58726,5431,31053,94572,189782
1015465,51339,38323,99593,29399,218654
1015466,3248,76171,27653,3006,110078
1015467,90807,77963,43868,68175,280813
1015468,90408,54729,70761,63552,279450
1015469,14137,82068,91583,36972,224760
1015470,3257,89477,10446,28880,132060
1015471,82520,48635,89472,11837,232464
1015472,49616,60455,56648,83031,249750
1015473,97105,25746,98296,5049,226196
1015474,9237,6027,31663,33787,80714
1015475,17544,98040,81639,75741,272964
1015476,24427,18438,41195,14676,98736
1015477,16519,14920,21024,9620,62083
1015478,34802,55473,61193,13388,164856
1015479,16300,22249,69403,12329,120281
1015480,51814,28763,61320,26497,168394
1015481,23653,40755,60048,78270,202726
1015482,66870,48299,67859,11359,194387
1015483,84680,86649,84882,97787,353998
1015484,16899,72725,73473,46015,209112
1015485,346,19714,69316,27541,116917
1015486,9875,71164,40257,30503,151799
1015487,59867,24887,79018,58975,222747
1015488,73569,53421,42822,13589,183401
1015489,62421,59174,83093,4360,209048
1015490,63281,6558,86444,4644,160927
1015491,66751,26758,17223,39808,150540
1015492,65133,3366,28856,92313,189668
1015493,7427,79870,64104,67884,219285
1015494,13721,29206,29999,82147,155073
1015495,4501,19389,74154,51674,149718
1015496,74362,65427,13558,10477,163824
1015497,47037,8140,29724,23109,108010
1015498,97549,82809,91943,94134,366435
1015499,67630,40266,25162,95979,229037
1015500,65221,87653,4596,73355,230825
1015501,13204,44602,90447,39804,188057
1015502,86320,21669,16724,64037,188750
1015503,57541,23988,57228,23392,162149
1015504,11387,12457,27330,98899,150073
1015505,82783,55317,43641,8593,190334
1015506,13824,81370,37962,40500,173656
1015507,94979,6348,24164,2019,127510
1015508,17348,48563,35152,91686,192749
1015509,45777,43714,82455,42426,214372
1015510,97956,75913,73014,73448,320331
1015511,37013,57671,35227,4123,134034
1015512,24670,7355,27568,50360,109953
1015513,53574,61685,1478,5467,122204
1015514,21463,23783,82417,14072,141735
1015515,6372,9608,87011,1678,104669
1015516,21744,61075,79534,51646,213999
1015517,70491,63408,99992,50665,284556
1015518,10395,78742,27778,89337,206252
1015519,86625,37108,58968,85808,268509
1015520,1833,64307,11540,69268,146948
1015521,13081,62004,1290,55635,132010
1015522,40040,6255,66445,12125,124865
1015523,75107,24961,61972,91513,253553
1015524,54544,4042,22902,64301,145789
1015525,31677,81756,11119,38525,163077
1015526,25139,28751,98246,78629,230765
1015527,53041,299,93585,96373,243298
1015528,48676,37024,52821,77934,216455
1015529,77181,87901,38503,83041,286626
1015530,14798,91631,49541,71063,227033
1015531,48945,91431,58325,92342,291043
1015532,92765,9268,49899,395,152327
1015533,50402,19115,53623,27591,150731
1015534,30434,92045,36636,25563,184678
1015535,56911,1700,17663,5844,82118
1015536,12859,48239,48316,6284,115698
1015537,1221,8420,48792,2050,60483
1015538,55339,69062,47303,63772,235476
1015539,48760,13645,65879,77559,205843
1015540,26467,59223,15813,79210,180713
1015541,42367,50736,8650,28385,130138
1015542,98958,66217,3442,83691,252308
1015543,40816,51938,73095,32076,197925
1015544,41559,30171,49986,81430,203146
1015545,94734,96056,18616,18323,227729
1015546,95208,35136,62575,99634,292553
1015547,98705,74039,33758,82805,289307
1015548,41470,20303,31781,8680,102234
1015549,24948,84552,60391,91340,261231
1015550,84932,80678,45428,26795,237833
1015551,91419,49331,46226,74925,261901
1015552,15000,64685,49464,79383,208532
1015553,79854,6412,12204,69452,167922
1015554,17550,47414,83531,61315,209810
1015555,10222,90313,12726,7639,120900
1015556,19512,26515,59017,40196,145240
1015557,63796,96568,85323,77327,323014
1015558,27792,7498,54771,26293,116354
1015559,9060,87984,43348,94656,235048
1015560,91623,21234,27466,47066,187389
1015561,75065,44351,27413,68727,215556
1015562,18340,24447,55659,81684,180130
1015563,80267,8250,47931,22757,159205
1015564,48650,51616,64310,26615,191191
1015565,79532,27661,60031,81458,248682
1015566,83011,62172,92829,29826,267838
1015567,56653,88507,86853,4974,236987
1015568,36032,87676,80830,77542,282080
1015569,93590,10249,71059,48371,223269
1015570,86171,79202,77677,56845,299895
1015571,4630,9003,34235,73698,121566
1015572,6276,39611,22720,86797,155404
1015573,19269,2766,69264,52480,143779
1015574,16938,61982,33714,5822,118456
1015575,23611,8145,85497,75596,192849
1015576,47421,11893,53824,46397,159535
1015577,13695,14522,40895,46422,115534
1015578,30443,80320,50187,2042,162992
1015579,99837,96904,9413,17306,223460
1015580,17043,33501,18367,65740,134651
1015581,58162,72124,84883,46562,261731
1015582,60188,896,59302,2081,122467
1015583,65395,93172,15701,29461,203729
1015584,23119,69800,63395,16871,173185
1015585,63239,63861,37112,99424,263636
1015586,15154,4732,78562,68491,166939
1015587,21399,48175,48142,91108,208824
1015588,55494,27195,1087,3619,87395
1015589,29533,24315,81887,81144,216879
1015590,11147,73321,57000,78360,219828
1015591,59990,27613,43550,88782,219935
1015592,62672,76512,3450,24041,166675
1015593,18477,33267,87871,7645,147260
1015594,318,48333,62449,61607,172707
1015595,81675,37132,78842,18702,216351
1015596,21068,236,72168,45263,138735
1015597,10047,32350,94921,97326,234644
1015598,44912,39124,94447,80181,258664
1015599,3422,54892,34580,1026,93920
1015600,36227,2470,88567,61734,188998
1015601,61268,74031,57069,51419,243787
1015602,21974,5796,21561,71668,120999
1015603,1406,42462,83850,19698,147416
1015604,33657,87792,69670,43220,234339
1015605,9113,92866,23168,95758,220905
1015606,67930,68273,40843,14838,191884
1015607,22932,76231,8226,872,108261
1015608,2690,28790,72322,47434,151236
1015609,88022,79834,35381,30945,234182
1015610,87171,47459,99992,3362,237984
1015611,76541,72407,48932,44193,242073
1015612,56826,44718,71004,69958,242506
1015613,74291,8204,8278,36745,127518
1015614,70855,43980,70223,27926,212984
1015615,10457,48916,19652,61995,141020
1015616,16607,60055,46901,42554,166117
1015617,96621,57787,36592,6625,197625
1015618,1250,73460,69835,27054,171599
1015619,2325,88193,76711,68367,235596
1015620,31331,8351,77314,75931,192927
1015621,6226,55818,25842,76144,164030
1015622,98510,56289,53928,28056,236783
1015623,61049,73952,72405,12471,219877
1015624,75970,52128,13536,87314,228948
1015625,2047,69235,66756,99107,237145
1015626,94109,93901,45681,59610,293301
1015627,67649,89751,47945,29269,234614
1015628,92235,33547,89930,48412,264124
1015629,91524,29166,37606,75631,233927
1015630,54683,79884,29417,92447,256431
1015631,27782,90915,59595,87529,265821
1015632,52102,20273,46919,37225,156519
1015633,68013,83756,40536,76042,268347
1015634,2572,39497,66729,50964,159762
1015635,45168,82489,93766,34096,255519
1015636,10265,45903,42459,60275,158902
1015637,24697,54442,44838,61789,185766
1015638,73009,37398,64779,94208,269394
1015639,32770,17699,7349,54189,112007
1015640,28020,57492,58638,83484,227634
1015641,17443,45248,13678,73398,149767
1015642,24259,63863,87399,27839,203360
1015643,59472,32704,47978,31393,171547
1015644,43143,84700,99165,71996,299004
1015645,68754,93175,35143,68209,265281
1015646,12062,18905,65435,1618,98020
1015647,26419,25254,81755,24755,158183
1015648,47003,13254,37171,34480,131908
1015649,34598,42733,15797,41421,134549
1015650,37152,30717,76267,66392,210528
1015651,67193,9560,73191,96788,246732
1015652,77495,49090,84061,53546,264192
1015653,95237,96619,46183,18450,256489
1015654,13826,85111,49261,72712,220910
1015655,57466,9395,99095,65966,231922
1015656,49364,10262,20766,34931,115323
1015657,765,44091,36433,95594,176883
1015658,28036,83489,68409,10641,190575
1015659,54259,88266,95180,26105,263810
1015660,21863,45126,34503,31982,133474
1015661,79554,15083,29129,26028,149794
1015662,80658,55399,50290,9877,196224
1015663,18506,34590,63998,98053,215147
1015664,14310,32968,43073,86933,177284
1015665,35094,45452,18007,54316,152869
1015666,68782,62193,91579,43967,266521
1015667,77773,38198,90407,77188,283566
1015668,68025,29556,78265,78762,254608
1015669,81299,19891,83815,2031,187036
1015670,12589,94715,1874,53328,162506
1015671,1852,79305,72331,16691,170179
1015672,88463,4666,201,64721,158051
1015673,65266,90050,33791,99118,288225
1015674,20878,6323,68920,83890,180011
1015675,43018,81267,49969,97296,271550
1015676,38173,57197,34683,40293,170346
1015677,40587,3602,36562,24310,105061
1015678,49565,68954,60158,67035,245712
1015679,2253,55437,19260,77108,154058
1015680,55084,22687,37408,90619,205798
1015681,87574,85270,58060,51042,281946
1015682,61626,17413,37482,24770,141291
1015683,35683,93053,62626,92632,283994
1015684,62095,49479,39120,13890,164584
1015685,71907,91289,42150,30976,236322
1015686,31977,83666,56116,52341,224100
1015687,34586,61774,45545,99813,241718
1015688,57424,85871,93590,2696,239581
1015689,11421,946,38816,40678,91861
1015690,82196,70775,72910,31530,257411
1015691,46875,96585,43592,10283,197335
1015692,46190,20836,66627,49333,182986
1015693,34095,44638,84847,94814,258394
1015694,61795,45977,93357,9356,210485
1015695,19777,289,28076,60712,108854
1015696,40127,23787,4098,25980,93992
1015697,27742,77337,95195,78906,279180
1015698,29080,34765,84785,19260,167890
1015699,55186,70883,48103,21546,195718
1015700,32104,64640,85948,50747,233439
1015701,8763,26322,31666,66644,133395
1015702,7725,75361,52346,89410,224842
1015703,39869,18228,73971,31770,163838
1015704,37860,44128,30141,7310,119439
1015705,78019,76164,51923,96279,302385
1015706,72879,53839,20440,56223,203381
1015707,18256,82881,24512,18032,143681
1015708,30815,57464,93373,36992,218644
1015709,87652,6220,1814,55698,151384
1015710,263,26984,5517,38622,71386
1015711,32898,81215,13757,70472,198342
1015712,39258,85060,46342,50921,221581
1015713,25653,46160,95499,82141,249453
1015714,97705,68536,78560,99687,344488
1015715,39622,64096,64136,77563,245417
1015716,34711,42972,48430,8456,134569
1015717,74936,36244,78685,72968,262833
1015718,55324,91912,12663,87834,247733
1015719,13476,58046,35960,65350,172832
1015720,30693,51339,53187,33631,168850
1015721,16923,26221,30532,5768,79444
1015722,54016,79496,95207,30598,259317
1015723,70694,69754,68804,32344,241596
1015724,58105,34745,47964,46972,187786
1015725,38268,72899,17248,15954,144369
1015726,87787,66344,87754,17382,259267
1015727,12221,98635,58621,43025,212502
1015728,777,41013,96835,97423,236048
1015729,17223,26052,84876,31233,159384
1015730,61504,82416,13988,22244,180152
1015731,32164,30898,17754,13681,94497
1015732,55688,90249,97171,70860,313968
1015733,19788,20529,95330,36843,172490
1015734,67640,29428,37526,72381,206975
1015735,22292,60257,34625,51689,168863
1015736,83822,85935,7442,88250,265449
1015737,64723,88650,70530,78289,302192
1015738,15989,13796,33274,1034,64093
1015739,81972,66461,16818,12565,177816
1015740,30816,52643,59185,34865,177509
1015741,653,10180,39323,2365,52521
1015742,77072,52390,25403,25674,180539
1015743,41609,55522,62091,20564,179786
1015744,96260,13406,37987,99860,247513
1015745,58810,29845,13469,56769,158893
1015746,18807,47919,28955,21027,116708
1015747,62532,7727,92448,84544,247251
1015748,51334,70484,7393,67026,196237
1015749,44748,35204,26713,52275,158940
1015750,19872,67889,90329,65045,243135
1015751,11969,69140,26186,8382,115677
1015752,24066,22249,33431,57847,137593
1015753,4154,23968,87565,5662,121349
1015754,15160,11660,10488,15093,52401
1015755,53777,7768,4029,40223,105797
1015756,54040,25941,9540,96095,185616
1015757,35878,71974,36408,73091,217351
1015758,75499,37244,93450,51777,257970
1015759,61020,2465,63864,8484,135833
1015760,77226,1751,41172,49427,169576
1015761,73693,38964,44132,84702,241491
1015762,32202,50409,22069,40107,144787
1015763,28197,95326,66801,69603,259927
1015764,80877,86943,94571,15629,278020
1015765,81608,34554,19591,71684,207437
1015766,10279,52082,96926,81280,240567
1015767,65922,94363,81990,71075,313350
1015768,62138,13734,47837,21044,144753
1015769,10786,29444,29692,52627,122549
1015770,77480,6827,82989,77906,245202
1015771,95816,35033,94743,5072,230664
1015772,60265,28252,11923,18453,118893
1015773,24446,29493,99642,48938,202519
1015774,3178,85086,34083,59949,182296
1015775,57106,94126,7864,45072,204168
1015776,18251,93623,70768,82040,264682
1015777,68558,17439,88711,15428,190136
1015778,73547,93114,52178,2255,221094
1015779,30030,27513,28771,37783,124097
1015780,49624,8321,84648,47700,190293
1015781,3183,64482,76317,44379,188361
1015782,13419,26042,75977,90698,206136
1015783,22355,23887,55864,29599,131705
1015784,94233,4021,46951,6249,151454
1015785,19407,77746,86709,46186,230048
1015786,93683,22325,19184,39789,174981
1015787,27480,16038,34344,16329,94191
1015788,67313,65500,55390,16480,204683
1015789,33437,79150,59413,81141,253141
1015790,28340,46275,64776,31597,170988
1015791,73859,24157,4978,27222,130216
1015792,59761,74244,35215,50940,220160
1015793,29248,17652,89526,74573,210999
1015794,70583,76946,87136,30786,265451
1015795,64716,80728,76466,4686,226596
1015796,33036,85427,65989,96598,281050
1015797,51845,10392,94827,63315,220379
1015798,98401,77723,28172,29942,234238
1015799,16146,19841,27611,38456,102054
1015800,33388,95449,90640,85206,304683
1015801,40973,13850,16313,93704,164840
1015802,99426,43334,18478,70849,232087
1015803,53360,51086,86032,495,190973
1015804,90844,79195,46280,36979,253298
1015805,27752,80665,65382,2184,175983
1015806,15790,66854,74604,58668,215916
1015807,88934,91253,7739,14310,202236
1015808,84805,69390,95058,28775,278028
1015809,17658,56873,56201,26530,157262
1015810,89212,6219,39936,55152,190519
1015811,86901,70995,70626,56141,284663
1015812,25733,4077,51287,51162,132259
1015813,63320,94663,41459,93367,292809
1015814,90302,62506,49687,60301,262796
1015815,26804,76724,37375,90331,231234
1015816,84213,59051,97250,46949,287463
1015817,91889,31843,95109,85107,303948
1015818,65789,59550,75401,38537,239277
1015819,69462,99389,93112,53774,315737
1015820,34849,72684,321,69248,177102
1015821,27291,55714,34034,32173,149212
1015822,52998,30676,3106,90489,177269
1015823,69624,197,57614,34085,161520
1015824,45261,74470,20683,10076,150490
1015825,59520,82557,75149,57416,274642
1015826,12823,33937,60545,44534,151839
1015827,84424,39472,12542,77848,214286
1015828,42808,86621,3361,95940,228730
1015829,68392,85339,86602,90492,330825
1015830,29385,21306,65400,17367,133458
1015831,87729,66337,41633,38500,234199
1015832,1392,73248,62710,96489,233839
1015833,9870,56530,39009,18398,123807
1015834,75260,27790,22343,67043,192436
1015835,79874,59962,42532,20666,203034
1015836,83697,10826,23231,35404,153158
1015837,18015,71069,76654,1320,167058
1015838,80757,33910,4028,27636,146331
1015839,14968,97194,72772,52172,237106
1015840,43283,87439,34452,19106,184280
1015841,74489,26310,5369,96189,202357
1015842,80467,52259,25096,3022,160844
1015843,85133,47704,56772,53278,242887
1015844,55310,57287,7707,71932,192236
1015845,29123,53965,25537,76401,185026
1015846,18679,93208,12155,86005,210047
1015847,91543,93502,48529,8853,242427
1015848,98898,39214,77830,88486,304428
1015849,41192,4361,88634,28166,162353
1015850,22728,27957,38787,57001,146473
1015851,62593,13738,95013,98640,269984
1015852,17353,5439,88777,77529,189098
1015853,17179,43533,56575,96217,213504
1015854,44222,77584,5554,56906,184266
1015855,68390,59221,53899,58815,240325
1015856,85368,53733,50316,5059,194476
1015857,81064,8300,42364,86729,218457
1015858,19257,22253,38307,66289,146106
1015859,26368,67730,49525,77636,221259
1015860,48959,65599,48837,58326,221721
1015861,57884,11233,94770,84972,248859
1015862,42033,71286,51067,15146,179532
1015863,64350,3841,97097,19172,184460
1015864,27223,19528,12196,39415,98362
1015865,34337,61294,67229,67123,229983
1015866,53862,989,85118,23666,163635
1015867,25321,15790,95451,96136,232698
1015868,51909,13348,40220,81944,187421
1015869,84712,80025,62691,82108,309536
1015870,88511,27988,53875,884,171258
1015871,83440,38924,79664,21370,223398
1015872,7689,12681,21078,38670,80118
1015873,30168,90613,11564,61990,194335
1015874,85882,74857,52825,41242,254806
1015875,82122,63171,74067,57945,277305
1015876,81221,42949,20737,65342,210249
1015877,37490,34046,62377,47667,181580
1015878,2961,50926,19279,15422,88588
1015879,36295,16992,95250,30818,179355
1015880,14184,33414,64865,27845,140308
1015881,5143,48295,49890,92410,195738
1015882,42991,52839,61589,32190,189609
1015883,96485,69444,52411,24710,243050
1015884,25601,40917,85216,49949,201683
1015885,21617,57156,53055,76185,208013
1015886,48264,3612,68389,72604,192869
1015887,6297,84386,16480,59411,166574
1015888,17029,73090,54904,21615,166638
1015889,67334,31538,35446,4621,138939
1015890,77377,17239,45520,48609,188745
1015891,50107,39579,98807,49450,237943
1015892,23370,33099,36577,56864,149910
1015893,26445,86212,56454,21515,190626
1015894,20219,32549,40280,7006,100054
1015895,29353,33955,43165,7270,113743
1015896,45985,39644,28036,31422,145087
1015897,36005,33886,56657,24676,151224
1015898,45068,14360,15561,23523,98512
1015899,3895,92470,79836,50952,227153
1015900,13171,39451,73635,18034,144291
1015901,79733,58705,58285,12623,209346
1015902,19815,13053,94064,8900,135832
1015903,74081,49251,38110,87427,248869
1015904,21758,72390,75941,82631,252720
1015905,87275,43227,64495,54014,249011
1015906,17853,75261,70103,40042,203259
1015907,46901,80013,98065,70315,295294
1015908,74534,72635,56000,76714,279883
1015909,22907,24807,16421,94816,158951
1015910,37709,5449,3020,71493,117671
1015911,12307,11376,74192,54570,152445
1015912,1728,49866,30500,70390,152484
1015913,8227,30091,75172,61763,175253
1015914,39407,4906,57961,30013,132287
1015915,65972,41723,44336,70884,222915
1015916,46303,36411,77395,85788,245897
1015917,83661,56459,45626,30895,216641
1015918,72049,31262,54873,69454,227638
1015919,14771,77724,35934,75393,203822
1015920,4035,45541,11175,91198,151949
1015921,98868,2098,47936,51386,200288
1015922,84063,60501,11282,85728,241574
1015923,16051,93454,60603,58468,228576
1015924,64853,18818,88508,38853,211032
1015925,11049,17011,1,4798,32859
1015926,4525,39654,3154,98163,145496
1015927,9372,21635,18101,72719,121827
1015928,60615,13345,12287,25051,111298
1015929,57534,31336,6911,91253,187034
1015930,8566,53387,58576,66612,187141
1015931,65338,75275,49498,33228,223339
1015932,45885,69782,67731,21484,204882
1015933,76735,53890,75710,8241,214576
1015934,41195,85302,75314,64170,265981
1015935,30107,35357,72011,19467,156942
1015936,96718,13959,93878,80675,285230
1015937,87250,60374,38823,28163,214610
1015938,89537,65253,32728,27274,214792
1015939,5358,63357,47986,28839,145540
1015940,64803,24809,46202,15359,151173
1015941,84852,90334,55945,12079,243210
1015942,54114,83876,34596,48434,221020
1015943,91786,84881,97225,47214,321106
1015944,23662,54482,4413,47263,129820
1015945,62670,69290,56395,19544,207899
1015946,57409,19232,55207,24122,155970
1015947,62156,48289,90830,93263,294538
1015948,15454,8084,89971,50234,163743
1015949,20054,15386,25281,21957,82678
1015950,80104,58919,56639,69986,265648
1015951,66913,15167,64952,58454,205486
1015952,63082,43255,79822,503,186662
1015953,30186,15279,12661,24084,82210
1015954,96551,19557,16426,68507,201041
1015955,68271,22626,25537,24118,140552
1015956,43558,89872,85214,18167,236811
1015957,79351,87398,80414,4121,251284
1015958,1559,3290,20665,98128,123642
1015959,40384,19447,41951,92906,194688
1015960,68250,66917,67175,60743,263085
1015961,73633,39888,16457,77384,207362
1015962,44545,31396,90083,86586,252610
1015963,59535,5091,85600,70493,220719
1015964,24727,59169,78906,58121,220923
1015965,45611,79654,92804,16677,234746
1015966,26505,2594,86949,22880,138928
1015967,40215,78896,47607,40773,207491
1015968,52162,53794,61863,69304,237123
1015969,38952,9446,28409,99046,175853
1015970,64115,94732,59008,38166,256021
1015971,13802,27990,75354,57135,174281
1015972,39918,87593,65789,58012,251312
1015973,7169,38769,42068,24107,112113
1015974,79687,4806,51512,8385,144390
1015975,31930,63262,89500,57074,241766
1015976,87147,85444,4746,3254,180591
1015977,77002,94061,74748,19447,265258
1015978,54704,63922,6349,85196,210171
1015979,87901,28912,21328,17078,155219
1015980,52127,69648,39385,59214,220374
1015981,74237,44189,87694,92402,298522
1015982,73614,55042,6720,41551,176927
1015983,85102,13391,28724,82881,210098
1015984,96004,75740,50349,23464,245557
1015985,4656,23426,32246,40565,100893
1015986,54368,19406,79386,10051,163211
1015987,63898,30934,16889,22160,133881
1015988,32597,54116,49430,58264,194407
1015989,87438,84170,6625,97509,275742
1015990,67407,8013,40529,3367,119316
1015991,55229,2957,79567,73488,211241
1015992,7008,15438,66805,11309,100560
1015993,72027,83133,87780,29770,272710
1015994,20586,6541,68284,7654,103065
1015995,40117,25516,47564,17798,130995
1015996,93606,89115,49829,20229,252779
1015997,921,50272,20011,47556,118760
1015998,87870,38581,32030,6406,164887
1015999,72013,18454,19410,33518,143395
1016000,78623,73555,31579,44848,228605
1016001,32110,75488,53551,49470,210619
1016002,26422,64527,33773,39971,164693
1016003,55647,59956,61547,63105,240255
1016004,92052,28440,79194,76798,276484
1016005,1046,42804,50940,37798,132588
1016006,27123,47883,78597,11031,164634
1016007,21459,30422,9273,44696,105850
1016008,90537,37741,66398,99895,294571
1016009,87991,9450,99643,16132,213216
1016010,91412,59489,5851,42395,199147
1016011,38433,10302,80051,174,128960
1016012,35817,10165,55248,35105,136335
1016013,32675,19679,67105,44533,163992
1016014,90526,23492,40146,14516,168680
1016015,28988,67921,34011,4754,135674
1016016,73040,33230,2165,95328,203763
1016017,79272,50919,8601,14566,153358
1016018,85928,96351,31149,6648,220076
1016019,8012,77766,59189,29572,174539
1016020,80997,44060,54841,50202,230100
1016021,89252,3856,78683,65708,237499
1016022,65992,80955,7488,90190,244625
1016023,57031,31538,46171,78798,213538
1016024,6293,55276,3052,82678,147299
1016025,65032,52095,64273,24645,206045
1016026,81494,91072,89098,83556,345220
1016027,69336,119,36837,51962,158254
1016028,40544,68105,63718,32913,205280
1016029,24350,66034,86507,76346,253237
1016030,98020,5391,64414,53344,221169
1016031,10033,24810,29105,89356,153304
1016032,75982,98145,94887,20923,289937
1016033,12448,90404,57168,61616,221636
1016034,754,98603,53395,89546,242298
1016035,57857,35803,38967,13503,146130
1016036,55032,70210,76782,93056,295080
1016037,85625,38014,84699,79838,288176
1016038,76939,67946,57695,39434,242014
1016039,82438,96776,63479,60786,303479
1016040,21458,39990,81172,3973,146593
1016041,5004,93573,58492,6528,163597
1016042,76499,7458,37682,39502,161141
1016043,69214,80621,33346,72943,256124
1016044,75109,90968,14500,68594,249171
1016045,99661,21759,22124,24780,168324
1016046,5385,2727,85634,12594,106340
1016047,96354,75624,28222,77313,277513
1016048,75113,18493,58633,51521,203760
1016049,48313,81633,60453,66249,256648
1016050,41524,41897,76473,27534,187428
1016051,93702,50250,91944,6290,242186
1016052,62948,23869,63121,5979,155917
1016053,71894,48940,64648,71949,257431
1016054,38459,28821,38213,60809,166302
1016055,31558,31308,66797,17931,147594
1016056,1239,36535,25238,12180,75192
1016057,1354,95921,45043,88337,230655
1016058,68796,16374,35671,52075,172916
1016059,19875,43329,90719,24813,178736
1016060,42900,68145,16977,16507,144529
1016061,86464,43546,75989,7051,213050
1016062,30578,44751,62814,32262,170405
1016063,8589,93705,62913,91505,256712
1016064,74958,48806,90115,72872,286751
1016065,63669,59189,18340,7924,149122
1016066,24973,47891,96796,85491,255151
1016067,51039,87795,13822,62248,214904
1016068,17143,39336,54175,30598,141252
1016069,44581,17967,9950,213,72711
1016070,30902,52013,70445,87803,241163
1016071,48422,64081,20389,16168,149060
1016072,82201,93664,4939,1002,181806
1016073,54996,81277,67161,38397,241831
1016074,68644,66661,80940,97609,313854
1016075,17055,2748,38275,5266,63344
1016076,9816,69933,53823,88312,221884
1016077,35947,77544,99429,1728,214648
1016078,75015,18028,83474,4836,181353
1016079,81379,28663,9977,10670,130689
1016080,77633,42149,41536,49589,210907
1016081,31656,10612,13471,65186,120925
1016082,72799,71755,35160,9570,189284
1016083,40499,576,75598,88553,205226
1016084,66422,33256,50353,18302,168333
1016085,61576,99446,37370,88347,286739
1016086,4414,49699,18329,76883,149325
1016087,25095,59194,4522,38265,127076
1016088,55521,65077,40932,24905,186435
1016089,52412,65094,40876,2457,160839
1016090,40475,26269,71838,17386,155968
1016091,17134,92091,15539,79248,204012
1016092,72628,43741,62197,19960,198526
1016093,8034,71906,99689,4862,184491
1016094,87986,36542,90395,31294,246217
1016095,90981,54815,63917,44887,254600
1016096,79207,60333,86949,28807,255296
1016097,33228,39992,80578,68083,221881
1016098,30146,8977,72886,98832,210841
1016099,90639,39252,9323,24810,164024
1016100,48318,8154,15666,14795,86933
1016101,31569,20493,90366,91315,233743
1016102,91644,79761,88262,67373,327040
1016103,47795,41403,15701,26617,131516
1016104,74233,51613,58311,67426,251583
1016105,414,19022,33602,44028,97066
1016106,75415,39582,40732,96919,252648
1016107,17707,18694,61742,92308,190451
1016108,99887,62046,77705,23531,263169
1016109,42795,57623,29974,44767,175159
1016110,90084,97796,31043,34732,253655
1016111,63080,62251,58952,82310,266593
1016112,30281,21813,58747,98760,209601
1016113,45334,77278,36612,25366,184590
1016114,23329,34471,51084,99632,208516
1016115,97402,53767,55027,22872,229068
1016116,80888,25230,96010,89763,291891
1016117,92645,46926,40918,11658,192147
1016118,70483,61336,67250,34967,234036
1016119,40859,20779,98644,7733,168015
1016120,16311,43030,85315,10109,154765
1016121,89229,34788,72555,9454,206026
1016122,55880,16584,18482,17493,108439
1016123,63737,11336,38799,82200,196072
1016124,33847,44195,11778,66096,155916
1016125,45573,12169,15283,48881,121906
1016126,52336,64462,19849,212,136859
1016127,15371,29398,59784,90152,194705
1016128,51776,20725,24644,30551,127696
1016129,91139,60612,71418,59955,283124
1016130,17139,93495,80497,59149,250280
1016131,68730,44081,59488,28569,200868
1016132,66328,43077,78080,91926,279411
1016133,64553,52783,92238,31944,241518
1016134,11432,12456,740,83289,107917
1016135,81265,4239,33107,81315,199926
1016136,25737,30355,80674,1692,138458
1016137,22721,79121,41065,54980,197887
1016138,4100,8500,33697,37250,83547
1016139,38156,75894,20057,97,134204
1016140,98634,86830,33850,47587,266901
1016141,3220,89528,56252,4854,153854
1016142,93783,26277,82877,57912,260849
1016143,26917,77473,15181,3525,123096
1016144,90581,65882,37829,412,194704
1016145,86620,80652,54144,18912,240328
1016146,56422,21283,55449,52589,185743
1016147,21651,50265,62203,19572,153691
1016148,51966,98640,78893,53361,282860
1016149,66692,17635,80081,10282,174690
1016150,77871,48063,8646,76636,211216
1016151,16925,20010,81707,26399,145041
1016152,39752,31412,40983,38584,150731
1016153,34775,84460,47877,10008,177120
1016154,68842,31070,92565,43620,236097
1016155,58560,6980,22190,87133,174863
1016156,39489,16685,44546,92562,193282
1016157,47359,51792,25975,28612,153738
1016158,74950,75142,41569,53112,244773
1016159,38464,3525,69992,7219,119200
1016160,5339,27334,22840,84320,139833
1016161,3657,39520,36309,16817,96303
1016162,38560,12496,98693,74262,224011
1016163,48440,23147,11089,33665,116341
1016164,62828,65859,85386,84079,298152
1016165,34421,71441,75538,43795,225195
1016166,76777,39267,6986,6551,129581
1016167,24069,642,45332,32798,102841
1016168,19675,6333,35366,31751,93125
1016169,82030,2563,36506,45779,166878
1016170,89938,95491,11317,54247,250993
1016171,34872,32713,57091,77009,201685
1016172,35052,13388,40046,25057,113543
1016173,66247,86962,23860,3794,180863
1016174,49081,17047,58840,72315,197283
1016175,1336,30187,21369,81422,134314
1016176,29788,66236,15729,3716,115469
1016177,89985,68130,80212,27866,266193
1016178,64539,79842,77666,3142,225189
1016179,62258,51222,40448,12656,166584
1016180,38716,99964,64005,17786,220471
1016181,64858,55737,53280,5939,179814
1016182,45638,70154,74687,98909,289388
1016183,68582,99684,25175,89772,283213
1016184,22312,90007,71513,36759,220591
1016185,15513,40619,16193,87648,159973
1016186,95050,21859,13189,69900,199998
1016187,91152,78870,16510,42141,228673
1016188,89389,85170,70224,43370,288153
1016189,76775,96663,4242,39681,217361
1016190,31671,43993,65106,96589,237359
1016191,94066,78898,90619,29939,293522
1016192,23223,21295,99605,69693,213816
1016193,23214,71494,96137,77496,268341
1016194,27803,9454,22460,7949,67666
1016195,2769,29552,38159,27448,97928
1016196,55578,61695,83508,8977,209758
1016197,42655,43794,13772,54780,155001
1016198,93143,719,73781,63940,231583
1016199,33447,77486,8959,38572,158464
1016200,38419,73901,24024,23754,160098
1016201,86319,49917,42601,19873,198710
1016202,39121,97263,25411,34327,196122
1016203,58219,66994,99558,63914,288685
1016204,3729,55763,74408,38910,172810
1016205,9247,88629,71285,28143,197304
1016206,20990,62467,71629,75923,231009
1016207,79384,55334,87084,60356,282158
1016208,47277,66658,63281,35505,212721
1016209,69178,80530,42087,836,192631
1016210,15386,72942,29652,76122,194102
1016211,93243,97908,34311,10250,235712
1016212,36561,51142,33518,8731,129952
1016213,55250,77711,10983,1727,145671
1016214,22841,79559,66998,77811,247209
1016215,47237,37629,48823,70570,204259
1016216,46845,41022,45092,40614,173573
1016217,15744,67219,66642,80201,229806
1016218,9178,92539,82155,5216,189088
1016219,34900,21941,26481,95742,179064
1016220,44205,65280,72975,31830,214290
1016221,56639,17121,70350,93090,237200
1016222,33928,608,61432,31716,127684
1016223,56112,86541,13663,37473,193789
1016224,6886,86661,11065,84819,189431
1016225,85629,16859,72212,12672,187372
1016226,45432,55857,98901,1718,201908
1016227,1,39061,88394,73111,200567
1016228,81250,20557,43165,67387,212359
1016229,46749,59417,65685,58264,230115
1016230,37114,53426,89533,68717,248790
1016231,7775,656,56931,29602,94964
1016232,94329,12763,21840,32242,161174
1016233,35254,59596,90403,89414,274667
1016234,60133,42124,75084,39700,217041
1016235,88126,59411,77146,29340,254023
1016236,67772,5021,17467,78477,168737
1016237,20556,40850,78757,97433,237596
1016238,83957,35108,6734,42455,168254
1016239,96312,69232,49759,17537,232840
1016240,11487,59347,99691,54182,224707
1016241,34357,26720,7450,73904,142431
1016242,53986,50707,94055,6885,205633
1016243,7389,67031,4103,91519,170042
1016244,39840,40675,85848,45960,212323
1016245,97721,23094,63531,99233,283579
1016246,47389,84801,11555,39519,183264
1016247,93436,73939,48345,4714,220434
1016248,88273,95462,90268,74948,348951
1016249,36086,71137,1620,72116,180959
1016250,10031,1476,34857,82905,129269
1016251,50377,76907,41948,80848,250080
1016252,17489,78006,50443,31588,177526
1016253,13882,28946,98468,71049,212345
1016254,34590,73268,87943,65994,261795
1016255,25029,1019,6767,66181,98996
1016256,56464,42994,61318,7281,168057
1016257,1126,71630,41427,60310,174493
1016258,80826,75167,5661,31252,192906
1016259,82235,20151,60232,30868,193486
1016260,80175,15183,19390,6418,121166
1016261,61337,98582,92928,71937,324784
1016262,4461,42642,36131,11686,94920
1016263,67835,85710,69156,60968,283669
1016264,97856,63810,37087,96508,295261
1016265,87425,21841,51103,89940,250309
1016266,56623,22269,37750,75945,192587
1016267,8446,74995,93768,30967,208176
1016268,28260,9659,1846,51753,91518
1016269,52936,31702,144,23079,107861
1016270,45087,55573,58826,21865,181351
1016271,19916,21175,41337,10335,92763
1016272,95750,29614,2037,22288,149689
1016273,42925,80939,3820,10448,138132
1016274,62637,94405,74651,7849,239542
1016275,19841,8824,15892,686,45243
1016276,81339,27507,52302,2704,163852
1016277,82487,65737,75825,15102,239151
1016278,723,91286,232,28421,120662
1016279,62331,95043,92206,86542,336122
1016280,98891,36926,71832,61136,268785
1016281,87475,93384,37067,74084,292010
1016282,32306,23689,44414,23321,123730
1016283,58687,28091,87950,7808,182536
1016284,89949,4125,83497,82775,260346
1016285,39265,30489,26923,26287,122964
1016286,55980,51573,44492,6700,158745
1016287,90675,7586,78555,70939,247755
1016288,25925,92208,77554,44886,240573
1016289,26756,58341,99085,90354,274536
1016290,29137,97531,89180,19197,235045
1016291,40119,60301,3951,28846,133217
1016292,31222,17960,49447,90346,188975
1016293,62207,69024,61856,92467,285554
1016294,33909,26119,1951,85554,147533
1016295,23347,71813,33585,50716,179461
1016296,23356,56437,39795,94888,214476
1016297,65253,49465,58471,58696,231885
1016298,36553,87879,66293,50957,241682
1016299,40886,46964,50061,51472,189383
1016300,27258,50499,38607,15386,131750
1016301,44151,34347,97847,42751,219096
1016302,11780,89543,79717,73748,254788
1016303,46878,8928,8493,57784,122083
1016304,39600,80061,29755,48639,198055
1016305,40249,63431,52416,23410,179506
1016306,70071,76760,19242,98201,264274
1016307,32639,12026,31865,64659,141189
1016308,66482,50048,46780,35269,198579
1016309,58783,82799,31389,99505,272476
1016310,75255,68746,45019,37998,227018
1016311,54922,31581,15850,19686,122039
1016312,27835,38560,7357,12941,86693
1016313,98756,92819,15056,24212,230843
1016314,25210,71101,76584,21809,194704
1016315,41788,7047,55949,25482,130266
1016316,93113,65333,66814,85615,310875
1016317,8680,64629,21801,97899,193009
1016318,56488,3167,22121,96760,178536
1016319,80415,64918,31109,59259,235701
1016320,79686,7265,5805,96285,189041
1016321,24663,19457,59160,18903,122183
1016322,65528,43943,50649,30859,190979
1016323,51375,40295,30796,75415,197881
1016324,25266,38380,51230,54423,169299
1016325,60837,63370,49439,83258,256904
1016326,79201,5116,74495,50907,209719
1016327,78112,94441,94444,82254,349251
1016328,70358,886,22816,64483,158543
1016329,14361,34471,88072,76186,213090
1016330,72007,37808,27162,88364,225341
1016331,63760,30392,92346,3887,190385
1016332,54090,84634,12794,54483,206001
1016333,73897,86138,8146,9400,177581
1016334,98175,25006,42494,4580,170255
1016335,83911,56846,18643,11751,171151
1016336,93699,54187,41169,64237,253292
1016337,15713,64355,24050,92763,196881
1016338,31142,85095,7421,15552,139210
1016339,57861,9629,84903,58742,211135
1016340,67695,4490,97053,89336,258574
1016341,8096,81830,27524,34074,151524
1016342,45092,92186,25564,6132,168974
1016343,10341,80711,59845,7841,158738
1016344,67472,6340,62471,21299,157582
1016345,62496,36056,60445,84502,243499
1016346,64456,36960,69594,89920,260930
1016347,34777,96669,84916,54027,270389
1016348,36427,36988,4067,99668,177150
1016349,69416,53106,48115,1010,171647
1016350,9953,62822,73567,83676,230018
1016351,15046,69100,23833,12156,120135
1016352,70579,94985,45760,23089,234413
1016353,65512,22329,82066,24990,194897
1016354,99458,91723,77292,98807,367280
1016355,85639,14795,21457,47391,169282
1016356,60506,10924,42524,33349,147303
1016357,78103,76525,81866,39870,276364
1016358,66491,94685,19063,32509,212748
1016359,49036,6052,30054,140,85282
1016360,53931,60725,49871,33101,197628
1016361,7704,23463,90899,26138,148204
1016362,22658,36271,99879,77835,236643
1016363,76726,40127,62995,7562,187410
1016364,63517,67524,39916,22103,193060
1016365,7306,12385,91969,54370,166030
1016366,28222,4789,32797,72193,138001
1016367,66145,59932,39022,17620,182719
1016368,45073,90296,66662,52606,254637
1016369,68507,64344,97080,70963,300894
1016370,4027,52102,17348,96526,170003
1016371,75052,3246,75814,91815,245927
1016372,18456,36781,40637,45765,141639
1016373,84026,50927,93957,98558,327468
1016374,29131,4150,24264,92599,150144
1016375,95079,54240,18217,49555,217091
1016376,96214,81443,70556,98384,346597
1016377,31251,4569,24482,42375,102677
1016378,61307,9115,67467,60189,198078
1016379,67376,69360,30562,99808,267106
1016380,94144,80455,38522,35002,248123
1016381,55953,54431,91011,49933,251328
1016382,92100,71965,44287,60687,269039
1016383,6506,26737,10850,93486,137579
1016384,57452,52541,1778,34979,146750
1016385,88434,93107,46130,94394,322065
1016386,54763,19574,33615,40726,148678
1016387,20063,89570,59192,41561,210386
1016388,31648,4296,81248,55048,172240
1016389,58889,52856,4840,81957,198542
1016390,70673,51859,21971,39582,184085
1016391,92479,834,53982,24195,171490
1016392,95336,98363,24744,78380,296823
1016393,93541,70622,71822,57764,293749
1016394,36757,86481,13548,43330,180116
1016395,69964,13275,9450,74915,167604
1016396,47899,23866,21060,96519,189344
1016397,4221,23648,91610,40803,160282
1016398,47569,34458,39558,97695,219280
1016399,99004,71902,64899,76116,311921
1016400,25323,37791,78262,53703,195079
1016401,76371,41368,82886,21329,221954
1016402,75002,68038,36021,43691,222752
1016403,6506,19638,11977,19612,57733
1016404,73261,87437,77064,83489,321251
1016405,75634,83775,85906,31713,277028
1016406,82977,33138,17574,3869,137558
1016407,6740,19631,47605,92140,166116
1016408,23046,11529,11704,14741,61020
1016409,31373,5915,50041,55862,143191
1016410,15771,46215,3153,60721,125860
1016411,45510,14405,17067,62590,139572
1016412,51092,95394,69850,45837,262173
1016413,72808,71375,87119,73360,304662
1016414,84859,15701,76202,51531,228293
1016415,56623,53880,4524,12077,127104
1016416,61509,85001,72728,34856,254094
1016417,39692,38551,43192,30536,151971
1016418,90917,32684,42539,62418,228558
1016419,63820,81440,25740,33738,204738
1016420,61023,56002,78902,84238,280165
1016421,93057,18409,33228,50936,195630
1016422,47963,19430,43489,10643,121525
1016423,87988,98292,27406,72844,286530
1016424,11144,60657,79562,71940,223303
1016425,68120,29337,11184,9093,117734
1016426,61011,15452,63805,1778,142046
1016427,71057,93936,8115,63727,236835
1016428,52058,21500,97331,3739,174628
1016429,32520,43921,67277,99179,242897
1016430,16936,72825,21417,16840,128018
1016431,69778,47928,60941,47250,225897
1016432,41971,89560,25684,44475,201690
1016433,15044,33443,33008,38943,120438
1016434,10769,34978,89849,90120,225716
1016435,45979,41395,47998,89727,225099
1016436,50224,94352,32326,65618,242520
1016437,17706,87431,51169,6273,162579
1016438,11892,28046,55671,49671,145280
1016439,36882,85119,43175,57500,222676
1016440,55143,13512,7921,1787,78363
1016441,79253,98875,49071,52440,279639
1016442,45063,96420,86314,42383,270180
1016443,70689,25352,78951,2800,177792
1016444,3747,72236,23524,30043,129550
1016445,35943,33389,23763,61333,154428
1016446,8768,28433,67734,7394,112329
1016447,88591,19052,30826,91820,230289
1016448,37171,17412,15385,31399,101367
1016449,69770,65191,59747,95961,290669
1016450,62435,66219,70077,56459,255190
1016451,98714,44830,25058,97212,265814
1016452,63587,21623,96783,17550,199543
1016453,61657,77326,62673,35821,237477
1016454,11952,17771,71145,39299,140167
1016455,74346,69165,35644,70161,249316
1016456,34947,75696,36318,73775,220736
1016457,96852,58001,23965,93685,272503
1016458,16627,11721,56966,46659,131973
1016459,86371,45084,20124,75562,227141
1016460,90723,22438,48367,24552,186080
1016461,83975,27549,12605,9462,133591
1016462,50310,64642,97564,77948,290464
1016463,48821,9569,77844,26172,162406
1016464,31772,30541,28829,67352,158494
1016465,41277,1382,76804,44902,164365
1016466,30787,6498,68843,70806,176934
1016467,67471,71882,58600,14840,212793
1016468,72605,2204,49165,32975,156949
1016469,54253,32914,34501,72780,194448
1016470,72209,85907,18836,26461,203413
1016471,91551,69831,32043,18382,211807
1016472,75129,55755,61931,1946,194761
1016473,36438,12706,82913,49131,181188
1016474,3304,66763,18575,46200,134842
1016475,80705,8861,70926,61482,221974
1016476,57149,64226,83433,34397,239205
1016477,35230,8074,49577,91227,184108
1016478,22641,20582,79904,49204,172331
1016479,86178,74654,84341,15923,261096
1016480,84278,66566,19014,84306,254164
1016481,10545,66959,54619,69099,201222
1016482,60426,14607,16835,78114,169982
1016483,41027,25827,61680,72673,201207
1016484,53933,99133,53158,29021,235245
1016485,42563,87598,21863,70809,222833
1016486,26956,87377,12961,64665,191959
1016487,90503,35437,15240,59587,200767
1016488,81284,23151,18884,90914,214233
1016489,78130,13385,39866,77724,209105
1016490,45690,72148,6722,49282,173842
1016491,84935,6705,28089,58523,178252
1016492,74208,30659,46752,62135,213754
1016493,18869,83253,84596,81172,267890
1016494,58915,48799,85458,18264,211436
1016495,29232,17470,92495,48033,187230
1016496,32164,40316,50268,19418,142166
1016497,32554,36662,71820,63332,204368
1016498,21231,36422,36918,10575,105146
1016499,56218,76703,51591,41818,226330
1016500,47793,49767,11756,63362,172678
1016501,70383,26944,85042,75130,257499
1016502,19848,25309,37928,19762,102847
1016503,72801,42431,37091,35168,187491
1016504,1045,68963,78323,44895,193226
1016505,33589,56956,35547,54865,180957
1016506,61664,89862,96760,16417,264703
1016507,16768,13103,75027,83796,188694
1016508,88901,2982,50613,234,142730
1016509,368,94696,48084,44957,188105
1016510,12221,37645,77325,21023,148214
1016511,72977,89542,33645,96841,293005
1016512,41799,25659,87684,97812,252954
1016513,6472,75100,39505,23120,144197
1016514,30749,64521,87171,92110,274551
1016515,34083,51969,8164,46369,140585
1016516,79989,15072,35211,44903,175175
1016517,35134,13452,38744,18747,106077
1016518,42815,91735,24079,16281,174910
1016519,54682,80495,38454,91721,265352
1016520,73170,19263,31206,50191,173830
1016521,40165,73594,78419,62725,254903
1016522,10572,44972,57085,63471,176100
1016523,81345,29399,88003,7526,206273
1016524,29699,98546,78296,8242,214783
1016525,53078,34390,34542,2324,124334
1016526,16939,38086,19426,16656,91107
1016527,94420,92743,41160,1900,230223
1016528,30639,58419,28682,83259,200999
1016529,34379,97381,26464,42712,200936
1016530,82420,97458,97972,57167,335017
1016531,88907,27348,31973,71539,219767
1016532,9751,54051,9707,1546,75055
1016533,31855,79069,83283,96727,290934
1016534,44914,44559,76757,20078,186308
1016535,68375,81428,50843,63188,263834
1016536,6398,39717,89437,76209,211761
1016537,32440,79173,23740,45739,181092
1016538,32695,33923,82381,79745,228744
1016539,30910,68725,71616,90360,261611
1016540,90952,5577,20515,17296,134340
1016541,40712,87995,81856,68524,279087
1016542,64609,90314,94868,41680,291471
1016543,65359,25225,5400,71028,167012
1016544,23463,27995,98629,900,150987
1016545,37054,45386,56225,21009,159674
1016546,64698,1871,53816,84891,205276
1016547,40431,1297,86433,53491,181652
1016548,26447,43279,88799,34169,192694
1016549,98101,97661,67954,33205,296921
1016550,29821,7084,97370,6953,141228
1016551,43868,14809,28311,33790,120778
1016552,42486,98896,30512,75225,247119
1016553,43246,62486,30177,3375,139284
1016554,35534,8219,95679,78031,217463
1016555,78530,33088,66398,58313,236329
1016556,87690,20489,54997,86200,249376
1016557,35679,31262,68572,81069,216582
1016558,94628,21215,5033,58071,178947
1016559,19784,34446,18031,75801,148062
1016560,24580,3798,70226,95591,194195
1016561,31493,91224,56159,46302,225178
1016562,73161,35947,965,47154,157227
1016563,90903,77356,66487,85154,319900
1016564,90961,59839,88087,25454,264341
1016565,57016,52722,24017,40071,173826
1016566,62236,65229,43814,43907,215186
1016567,56696,56852,86968,80028,280544
1016568,76013,42076,84938,46575,249602
1016569,48290,19444,1503,83308,152545
1016570,4898,51965,68425,90985,216273
1016571,45476,22591,58556,26954,153577
1016572,76596,98610,19541,32158,226905
1016573,96402,46846,92203,63451,298902
1016574,74258,81097,32791,30154,218300
1016575,27899,92599,6630,15107,142235
1016576,29281,48836,26088,6259,110464
1016577,14613,38337,92954,45368,191272
1016578,75178,94487,75959,6328,251952
1016579,56968,21709,13476,75920,168073
1016580,48824,89479,73747,72842,284892
1016581,80497,49573,43186,25344,198600
1016582,11372,74714,9451,20250,115787
1016583,51284,45775,42231,40081,179371
1016584,97021,28093,38103,98434,261651
1016585,44213,61107,8350,63308,176978
1016586,90834,62392,5424,97498,256148
1016587,96566,82170,97978,19277,295991
1016588,64338,20900,97890,96563,279691
1016589,46047,8354,877,63679,118957
1016590,61426,92122,8226,8041,169815
1016591,15781,43922,53042,62129,174874
1016592,56389,2168,13796,38965,111318
1016593,91278,23941,50463,11786,177468
1016594,39944,69144,37985,65149,212222
1016595,49162,71508,34492,56758,211920
1016596,49278,89878,77607,83808,300571
1016597,44754,89941,17723,67567,219985
1016598,77830,99006,68766,64722,310324
1016599,37247,38222,92179,86068,253716
1016600,8056,26625,80844,5584,121109
1016601,4134,55279,71018,58188,188619
1016602,34044,49319,45757,45141,174261
1016603,56438,31865,75058,29252,192613
1016604,87318,62519,12485,28065,190387
1016605,48866,8967,55764,76372,189969
1016606,11312,64191,28697,80132,184332
1016607,98165,96968,97518,83489,376140
1016608,77840,71921,67359,16343,233463
1016609,73345,6411,13872,91566,185194
1016610,28894,15361,95560,88578,228393
1016611,7007,96863,45836,5981,155687
1016612,63921,3110,89619,85235,241885
1016613,51582,30415,61578,20533,164108
1016614,55217,2546,28818,70864,157445
1016615,37681,36460,8826,10260,93227
1016616,17620,33029,37785,56433,144867
1016617,27720,79764,55991,66091,229566
1016618,96344,20559,38888,92259,248050
1016619,88824,53754,79575,74314,296467
1016620,97459,75932,12250,85042,270683
1016621,23742,18390,80500,37550,160182
1016622,53161,25355,59882,33988,172386
1016623,94407,3275,61387,22471,181540
1016624,38866,45779,11065,30922,126632
1016625,30859,13347,66941,35701,146848
1016626,66651,69671,70243,50922,257487
1016627,64228,2724,5067,11479,83498
1016628,897,83538,91594,16433,192462
1016629,25477,48869,664,72482,147492
1016630,57213,12944,23237,94785,188179
1016631,92313,1219,24283,62689,180504
1016632,60467,93585,95987,95707,345746
1016633,44148,28141,94780,81518,248587
1016634,31004,50050,95470,89146,265670
1016635,99558,933,21665,42590,164746
1016636,67123,89235,75068,68569,299995
1016637,65634,6348,28892,57831,158705
1016638,63712,46838,68619,2597,181766
1016639,98604,86252,3083,72243,260182
1016640,71229,839,52456,40238,164762
1016641,24002,67957,4449,99002,195410
1016642,3642,4813,89178,34882,132515
1016643,26981,90088,74728,21251,213048
1016644,57755,604,4044,64825,127228
1016645,94515,13500,13702,41636,163353
1016646,10866,30836,86373,88992,217067
1016647,85657,91923,47818,92939,318337
1016648,49283,46622,50495,72767,219167
1016649,10692,68247,52205,74263,205407
1016650,71984,72439,16979,25819,187221
1016651,5930,13709,12198,84642,116479
1016652,3390,86486,83788,9661,183325
1016653,79130,24460,27815,4630,136035
1016654,17889,89842,70911,86411,265053
1016655,30930,30272,83888,27593,172683
1016656,1087,38774,11232,7225,58318
1016657,35253,82096,99216,7035,223600
1016658,58961,87660,43645,48841,239107
1016659,51695,11805,67969,91313,222782
1016660,91097,69977,65114,13014,239202
1016661,97545,73925,11145,44053,226668
1016662,22943,68868,55212,13235,160258
1016663,2024,99979,16105,58036,176144
1016664,81716,73811,96161,82413,334101
1016665,29529,55194,63455,95987,244165
1016666,45562,42153,4229,29648,121592
1016667,64944,8603,17430,58273,149250
1016668,84790,96947,82244,94720,358701
1016669,66786,43906,67129,86114,263935
1016670,363,8404,94194,11575,114536
1016671,11472,14118,70245,39431,135266
1016672,60548,94788,83700,14183,253219
1016673,15727,20649,84565,92603,213544
1016674,82175,46487,59969,95634,284265
1016675,51118,56634,54068,31709,193529
1016676,65869,44225,7118,73087,190299
1016677,84229,73308,48547,99470,305554
1016678,30143,28695,53825,62452,175115
1016679,66373,45697,74833,97837,284740
1016680,8915,36049,39955,21486,106405
1016681,76243,14499,99223,33536,223501
1016682,21971,26118,94643,4282,147014
1016683,48180,81613,71021,91195,292009
1016684,27854,6047,34462,11917,80280
1016685,62855,90710,50583,50689,254837
1016686,11424,43445,40151,53934,148954
1016687,70220,39350,21032,32941,163543
1016688,78045,33463,63791,96593,271892
1016689,67170,40696,71711,35933,215510
1016690,9728,17726,88538,46751,162743
1016691,78322,86958,55900,75578,296758
1016692,59672,1514,67295,46718,175199
1016693,28239,19670,91137,44738,183784
1016694,75749,45453,49798,944,171944
1016695,70572,57415,58890,87922,274799
1016696,49092,97053,46954,10176,203275
1016697,43846,77469,65563,52943,239821
1016698,31741,72873,65519,67746,237879
1016699,12530,37461,14583,33568,98142
1016700,50643,19324,58369,44231,172567
1016701,64582,50608,3332,16451,134973
1016702,24911,26326,60161,36934,148332
1016703,92562,2329,56654,75740,227285
1016704,55771,64043,49005,11740,180559
1016705,41698,67284,30926,97658,237566
1016706,71329,63120,97395,98864,330708
1016707,11085,23396,43045,69309,146835
1016708,96932,27831,95842,54310,274915
1016709,87419,16389,94965,66525,265298
1016710,34253,44892,73705,3796,156646
1016711,44523,24512,25812,88027,182874
1016712,7453,29657,81042,56205,174357
1016713,1432,65263,54832,11363,132890
1016714,29773,3033,66610,35595,135011
1016715,81625,71667,27639,40073,221004
1016716,85831,49383,60180,7229,202623
1016717,18492,75211,14453,82556,190712
1016718,47455,80396,7020,56307,191178
1016719,68087,89081,47236,52455,256859
1016720,41802,80363,57237,8289,187691
1016721,26226,36207,5921,20633,88987
1016722,35593,59561,98172,81042,274368
1016723,61679,70143,34734,58680,225236
1016724,71333,61242,27852,34722,195149
1016725,67340,42638,54064,59518,223560
1016726,40728,68387,90752,72050,271917
1016727,91629,43331,51142,31540,217642
1016728,32406,64851,51480,37987,186724
1016729,89514,96296,8162,99151,293123
1016730,44223,88109,16485,84178,232995
1016731,26442,29966,19470,11570,87448
1016732,13112,6845,18336,86756,125049
1016733,24659,72912,20806,8421,126798
1016734,25161,13828,55402,58622,153013
1016735,5174,88252,14331,2025,109782
1016736,62547,70292,81487,12698,227024
1016737,98769,10100,77307,86506,272682
1016738,63134,98888,69746,63630,295398
1016739,48112,55402,10759,64539,178812
1016740,72238,48984,10934,97552,229708
1016741,46968,21519,69647,89764,227898
1016742,40613,43092,41687,15301,140693
1016743,84053,45679,51229,53864,234825
1016744,36839,75673,65337,37275,215124
1016745,17083,15769,37323,84199,154374
1016746,81887,44640,2695,74671,203893
1016747,3958,74513,2352,82169,162992
1016748,4621,3216,7048,88785,103670
1016749,74345,41830,35985,26234,178394
1016750,19819,37278,64807,15406,137310
1016751,86939,60712,37241,84081,268973
1016752,21890,23038,99775,26280,170983
1016753,87044,10110,40619,52329,190102
1016754,57707,23923,91100,36681,209411
1016755,43612,42726,42489,85438,214265
1016756,16581,61936,76327,64736,219580
1016757,97318,83612,58658,49047,288635
1016758,84271,69626,4051,77275,235223
1016759,55199,53884,64758,84143,257984
1016760,15962,63877,10999,10397,101235
1016761,11944,33653,5955,74169,125721
1016762,29592,11434,68460,32899,142385
1016763,93620,11400,45068,43906,193994
1016764,35569,70240,44123,79400,229332
1016765,30714,66695,60702,56440,214551
1016766,23519,24954,65261,81178,194912
1016767,85031,83149,15703,93971,277854
1016768,31807,11916,61938,16608,122269
1016769,39911,3648,52232,6955,102746
1016770,10185,51186,72436,73267,207074
1016771,37997,78377,53044,54908,224326
1016772,52149,45064,60920,74795,232928
1016773,32951,5321,5791,41215,85278
1016774,27342,96991,5669,74614,204616
1016775,10722,46844,92988,72302,222856
1016776,52629,41038,21445,87468,202580
1016777,32759,5337,7658,32866,78620
1016778,662,48955,78907,88230,216754
1016779,10870,21502,1500,46822,80694
1016780,35859,35182,11445,34369,116855
1016781,23322,12015,22575,25240,83152
1016782,83824,27672,3041,69262,183799
1016783,12796,39120,44722,90742,187380
1016784,74584,8589,96422,75498,255093
1016785,74611,61522,49544,90235,275912
1016786,19112,1900,34272,2360,57644
1016787,91762,68448,58193,94679,313082
1016788,68184,79012,83761,64159,295116
1016789,1142,20900,92498,10999,125539
1016790,92548,59266,80167,32119,264100
1016791,45213,36869,22591,96377,201050
1016792,62040,82484,31306,10473,186303
1016793,4111,70647,31886,2725,109369
1016794,71481,32251,46676,4552,154960
1016795,20893,31345,62266,48501,163005
1016796,59350,28294,57423,35450,180517
1016797,38139,54843,16001,62092,171075
1016798,49319,92189,85726,36971,264205
1016799,73635,32817,61401,43905,211758
1016800,70754,74395,47350,61962,254461
1016801,29231,81282,88846,77487,276846
1016802,78367,98017,31384,22462,230230
1016803,13853,61805,15016,842,91516
1016804,97611,65298,12934,17146,192989
1016805,53882,34263,80661,92303,261109
1016806,93659,72140,14611,46828,227238
1016807,90056,93046,24456,471,208029
1016808,36773,601,14830,89496,141700
1016809,61946,8986,44483,46885,162300
1016810,99982,93128,56249,3332,252691
1016811,5839,10753,72715,79575,168882
1016812,61001,99036,13822,14603,188462
1016813,864,65767,55779,27018,149428
1016814,96810,4828,45529,75822,222989
1016815,44495,66283,40879,96522,248179
1016816,85454,83715,60438,43686,273293
1016817,81311,22381,91799,8043,203534
1016818,77224,47531,68158,7568,200481
1016819,37561,22999,51780,85033,197373
1016820,39992,75145,29623,2992,147752
1016821,35353,14249,87527,38747,175876
1016822,66620,19137,41907,8616,136280
1016823,34421,86384,94843,38354,254002
1016824,93379,3910,53525,98610,249424
1016825,28693,90348,27586,78211,224838
1016826,85177,38952,71854,61918,257901
1016827,11729,91760,26992,12109,142590
1016828,89310,17236,63356,67902,237804
1016829,27109,63674,49560,72494,212837
1016830,81060,25808,24971,35224,167063
1016831,52111,80902,4728,17911,155652
1016832,30996,67457,74763,37479,210695
1016833,73656,4517,61064,93015,232252
1016834,90652,19764,7166,88808,206390
1016835,35746,661,34828,75204,146439
1016836,32578,39204,23056,58913,153751
1016837,45504,40953,41636,70933,199026
1016838,33623,39772,62429,53232,189056
1016839,40402,30206,93906,39994,204508
1016840,29194,2771,35779,45191,112935
1016841,40511,38993,80259,87595,247358
1016842,47218,92223,8416,4925,152782
1016843,92499,94017,55091,3555,245162
1016844,77296,15593,82966,42306,218161
1016845,87467,65189,69671,4045,226372
1016846,18233,95006,56713,45545,215497
1016847,46883,1926,53188,61351,163348
1016848,16984,25421,15904,24485,82794
1016849,54781,52362,82621,37844,227608
1016850,12456,50748,70312,14020,147536
1016851,79783,28674,47473,97480,253410
1016852,74419,66568,36655,90858,268500
1016853,34085,32262,38462,3352,108161
1016854,80985,17029,24421,29534,151969
1016855,43130,40444,36469,37929,157972
1016856,78014,24866,15124,4931,122935
1016857,77749,38682,31746,90966,239143
1016858,93885,47213,48530,2129,191757
1016859,87874,51022,72267,70415,281578
1016860,50485,36518,88841,98518,274362
1016861,27516,30110,43739,67587,168952
1016862,39862,2606,40929,21476,104873
1016863,16811,71996,62125,39940,190872
1016864,35439,71395,40025,39293,186152
1016865,34168,48952,89631,30536,203287
1016866,23617,77544,72151,16599,189911
1016867,85041,84757,91984,78690,340472
1016868,77454,5095,560,79142,162251
1016869,30021,62707,19753,57740,170221
1016870,96307,34327,82423,42351,255408
1016871,65339,23144,91613,42897,222993
1016872,42656,74940,99344,74137,291077
1016873,14096,49232,31621,38559,133508
1016874,23978,21617,2866,46854,95315
1016875,9359,40751,10533,24246,84889
1016876,55877,82678,48365,84195,271115
1016877,14640,69562,69634,72857,226693
1016878,17020,55966,37221,64729,174936
1016879,77181,99402,80880,53933,311396
1016880,20105,425,40489,58247,119266
1016881,63272,59504,73916,30795,227487
1016882,77700,87350,97686,37412,300148
1016883,86713,78749,28346,82759,276567
1016884,76385,4612,6820,41078,128895
1016885,78651,84709,51648,24838,239846
1016886,16108,94920,83887,94177,289092
1016887,87,33303,84158,5328,122876
1016888,15393,80256,60162,62751,218562
1016889,19584,43059,86937,78563,228143
1016890,38621,68166,35756,1229,143772
1016891,22254,15803,91496,42443,171996
1016892,66500,67613,74964,75835,284912
1016893,32834,12470,64386,50130,159820
1016894,26598,64881,7535,74523,173537
1016895,17592,62482,97238,56023,233335
1016896,31178,30562,29233,96075,187048
1016897,95827,73185,78048,35311,282371
1016898,122,81455,75357,17695,174629
1016899,8115,41821,29511,6036,85483
1016900,57595,9873,28106,55527,151101
1016901,97680,92238,1319,43383,234620
1016902,93250,65779,49457,58072,266558
1016903,78902,62773,79970,49404,271049
1016904,11865,74794,61322,57253,205234
1016905,87374,38081,426,97283,223164
1016906,88535,31477,40199,78376,238587
1016907,60127,28023,44003,36094,168247
1016908,50433,77300,77631,19017,224381
1016909,55639,25659,16248,91606,189152
1016910,92121,78896,60891,44605,276513
1016911,52741,69092,33951,65427,221211
1016912,8493,89994,15631,71154,185272
1016913,18197,81848,48149,80606,228800
1016914,25377,67439,61551,5447,159814
1016915,10335,26744,94745,17866,149690
1016916,18690,14140,13200,76399,122429
1016917,83910,18708,50288,52167,205073
1016918,38339,651,50525,84517,174032
1016919,48690,96080,65428,8208,218406
1016920,62860,38508,77300,21810,200478
1016921,91943,92386,35351,85512,305192
1016922,63446,46125,18241,64753,192565
1016923,91670,49738,39675,92835,273918
1016924,36774,28657,31285,1324,98040
1016925,77529,39065,64539,14575,195708
1016926,60251,87700,19712,86801,254464
1016927,78954,77860,55383,15140,227337
1016928,44726,85837,5767,70705,207035
1016929,6709,24614,43033,54489,128845
1016930,42409,62740,36400,67952,209501
1016931,5984,94626,98553,75895,275058
1016932,57382,49662,71328,40010,218382
1016933,63635,1529,9095,89807,164066
1016934,89675,80883,79212,99712,349482
1016935,71759,19855,64715,84296,240625
1016936,42599,73071,42791,38396,196857
1016937,81482,18325,65542,33728,199077
1016938,46019,878,82799,11958,141654
1016939,43106,94887,58959,49833,246785
1016940,95897,16516,22800,26375,161588
1016941,79937,81742,95846,35503,293028
1016942,31216,7604,69797,73452,182069
1016943,13980,17525,93775,66409,191689
1016944,36457,55324,55528,984,148293
1016945,52163,5181,64949,90381,212674
1016946,53709,55323,50495,1164,160691
1016947,57307,1434,15293,66898,140932
1016948,28772,58578,5053,95886,188289
1016949,55765,31883,68797,51261,207706
1016950,56578,42957,19123,45692,164350
1016951,77126,39158,10519,24695,151498
1016952,44061,92618,84600,97388,318667
1016953,53227,34803,94601,78375,261006
1016954,7424,24060,39600,92167,163251
1016955,8540,16553,87627,23153,135873
1016956,20502,6347,58438,32604,117891
1016957,60880,78013,64841,6379,210113
1016958,38459,87219,83918,48333,257929
1016959,89327,32674,88655,39685,250341
1016960,2953,21150,82034,61536,167673
1016961,19896,24432,95777,46872,186977
1016962,34551,69946,95672,22871,223040
1016963,39001,79800,99429,68689,286919
1016964,49310,8211,11997,30554,100072
1016965,60647,18808,75401,40929,195785
1016966,5071,24374,43239,11729,84413
1016967,66490,8771,98884,8314,182459
1016968,87203,72563,86334,65905,312005
1016969,57099,79728,37525,64791,239143
1016970,8939,36960,74153,26705,146757
1016971,73077,7673,40079,47598,168427
1016972,55680,27979,94981,85937,264577
1016973,82470,32163,5450,20946,141029
1016974,98767,61072,96287,36187,292313
1016975,42925,52108,42435,1338,138806
1016976,68022,20167,98745,102,187036
1016977,51366,86603,68454,13390,219813
1016978,39906,85870,95904,2547,224227
1016979,44613,87700,82605,44507,259425
1016980,58656,58419,45501,59389,221965
1016981,84764,21724,29320,3522,139330
1016982,27264,88335,52949,25245,193793
1016983,18492,39369,34887,20132,112880
1016984,68357,35735,64116,42220,210428
1016985,57072,61898,72424,71015,262409
1016986,46427,4697,19983,575,71682
1016987,74215,11980,45665,76932,208792
1016988,30846,46630,1843,14052,93371
1016989,31977,76964,97347,18849,225137
1016990,59630,85228,93807,74676,313341
1016991,11418,1119,55637,15543,83717
1016992,89985,24718,352,24074,139129
1016993,11598,25526,86758,52160,176042
1016994,86213,17595,13990,94761,212559
1016995,7289,58393,87708,8387,161777
1016996,80082,57463,24272,16512,178329
1016997,98815,26047,58629,4737,188228
1016998,47323,61387,88928,9463,207101
1016999,10257,64840,7657,99734,182488
1017000,87700,32988,93405,86435,300528
1017001,50779,30793,30678,8409,120659
1017002,55876,95614,91142,21043,263675
1017003,96890,11160,30741,98313,237104
1017004,48094,87031,60871,29494,225490
1017005,89184,78573,26406,52555,246718
1017006,14749,48214,73181,35793,171937
1017007,98798,41596,56987,69654,267035
1017008,82131,81088,86325,36477,286021
1017009,53608,77499,28549,47516,207172
1017010,63151,20207,22413,7716,113487
1017011,85875,89236,92642,46732,314485
1017012,56632,97447,33248,5055,192382
1017013,80552,56379,53395,55697,246023
1017014,65064,62978,95937,71939,295918
1017015,27330,31816,29333,69712,158191
1017016,45251,68268,72419,40359,226297
1017017,27389,68213,24567,69594,189763
1017018,99554,77852,74821,15783,268010
1017019,57585,28898,6589,15419,108491
1017020,20298,59176,72020,86580,238074
1017021,67185,78852,72131,34754,252922
1017022,53731,15645,66888,72001,208265
1017023,3217,18422,91020,4247,116906
1017024,381,9965,76425,85718,172489
1017025,25966,48743,51047,55345,181101
1017026,59989,8692,33971,90813,193465
1017027,54524,38831,40825,18132,152312
1017028,94703,33624,87670,24180,240177
1017029,14481,88459,56037,31693,190670
1017030,40836,48068,41452,13657,144013
1017031,71947,4246,92206,59217,227616
1017032,61585,9938,65718,41638,178879
1017033,97037,56287,1571,57781,212676
1017034,33848,56176,67167,22094,179285
1017035,13976,77297,19473,56253,166999
1017036,90692,49709,59427,85351,285179
1017037,26763,31211,31861,46026,135861
1017038,1911,43214,463,1265,46853
1017039,74624,40541,57197,47143,219505
1017040,13688,78657,91592,31501,215438
1017041,43341,24686,82467,54370,204864
1017042,65645,97984,92335,97179,353143
1017043,23309,40362,41004,46870,151545
1017044,25134,49163,404,55877,130578
1017045,77509,13231,49556,39753,180049
1017046,36363,13687,10427,8478,68955
1017047,29259,97468,43586,86165,256478
1017048,49054,22396,65999,20697,158146
1017049,40245,58984,48877,73992,222098
1017050,48675,78414,49003,21152,197244
1017051,87640,23004,99464,12929,223037
1017052,12345,5737,43575,76549,138206
1017053,23739,90148,14410,44571,172868
1017054,74111,70772,95515,18799,259197
1017055,57200,97481,80104,81310,316095
1017056,44425,56791,64790,59044,225050
1017057,26926,20219,61663,41460,150268
1017058,56552,92847,59408,59791,268598
1017059,92609,12557,33896,62227,201289
1017060,92261,89116,50870,42338,274585
1017061,75409,77215,41816,4020,198460
1017062,60048,51448,59346,61596,232438
1017063,79723,35296,25279,33004,173302
1017064,37612,44569,84255,8399,174835
1017065,85578,53293,83410,81724,304005
1017066,42716,30438,91909,87574,252637
1017067,31974,9347,55628,20878,117827
1017068,90015,30781,36014,15684,172494
1017069,99405,89554,25241,94159,308359
1017070,89127,77679,49538,71588,287932
1017071,68620,89916,36953,149,195638
1017072,99318,52064,45512,32710,229604
1017073,71315,82469,11464,25616,190864
1017074,79875,61525,50101,16764,208265
1017075,26604,30604,36457,65749,159414
1017076,90750,92700,55875,39067,278392
1017077,73732,16252,19476,2845,112305
1017078,80089,892,93982,99207,274170
1017079,98293,5181,69434,90813,263721
1017080,92330,26637,79498,72766,271231
1017081,99241,1206,80410,27325,208182
1017082,70258,41621,70478,94773,277130
1017083,23403,98183,43661,45067,210314
1017084,63126,80863,16951,88623,249563
1017085,75620,76188,59371,87416,298595
1017086,12976,48514,30171,18170,109831
1017087,10233,69765,50324,16657,146979
1017088,97237,78188,80529,9342,265296
1017089,11372,5899,39795,22724,79790
1017090,39516,46189,92777,53255,231737
1017091,51849,18754,12018,64130,146751
1017092,35592,20105,27306,97960,180963
1017093,56703,48955,37427,18000,161085
1017094,92002,60824,3924,75658,232408
1017095,55811,6309,78641,25391,166152
1017096,90573,91509,64240,17980,264302
1017097,38730,44882,61755,10570,155937
1017098,83580,94496,99571,37802,315449
1017099,52226,97837,78108,52867,281038
1017100,26960,90053,2061,89057,208131
1017101,65566,71868,66267,17434,221135
1017102,26592,76525,34775,57574,195466
1017103,89531,6899,16473,63320,176223
1017104,5207,94800,56795,73837,230639
1017105,17779,43046,72031,97694,230550
1017106,81926,34028,19179,75894,211027
1017107,92613,67638,32162,99234,291647
1017108,28092,2798,39007,24321,94218
1017109,67593,35473,94949,15790,213805
1017110,23487,7294,63240,65982,160003
1017111,16034,89611,87939,69797,263381
1017112,70848,14165,93815,44023,222851
1017113,39041,20659,28152,88227,176079
1017114,2871,24754,40135,85581,153341
1017115,72609,727,17249,348,90933
1017116,97578,84318,70936,92290,345122
1017117,58600,28765,27582,44435,159382
1017118,73432,35589,65096,21911,196028
1017119,32366,89953,7376,82523,212218
1017120,29083,84437,84641,24339,222500
1017121,32577,41373,92301,86823,253074
1017122,19474,11871,65782,23816,120943
1017123,54026,7214,94443,24956,180639
1017124,5260,10370,37780,21515,74925
1017125,62095,14973,18924,93552,189544
1017126,60118,91346,38573,58140,248177
1017127,89070,10871,91029,45515,236485
1017128,99251,50020,6149,83269,238689
1017129,46828,49961,24189,95260,216238
1017130,9417,84183,25624,53469,172693
1017131,91279,81439,10221,22689,205628
1017132,52705,35127,65598,87312,240742
1017133,98647,86580,5802,7269,198298
1017134,61407,13965,89911,42294,207577
1017135,75781,43164,12448,52088,183481
1017136,54449,49337,32190,60634,196610
1017137,81657,6440,3822,51260,143179
1017138,26055,90067,17052,69927,203101
1017139,96230,67147,33570,82108,279055
1017140,72917,42604,51482,14290,181293
1017141,73916,59747,18035,56022,207720
1017142,92905,70166,15248,77130,255449
1017143,30064,20196,58376,17143,125779
1017144,43750,56782,63057,27896,191485
1017145,24090,25247,18667,21122,89126
1017146,28598,67634,85868,31974,214074
1017147,91158,81068,61466,92073,325765
1017148,94204,41611,91738,98468,326021
1017149,42400,21573,4445,42536,110954
1017150,81214,78571,18044,14706,192535
1017151,45984,39587,95178,27779,208528
1017152,36277,9797,3744,81129,130947
1017153,83769,77937,34667,72786,269159
1017154,74811,4348,82096,24661,185916
1017155,50870,77348,4619,87095,219932
1017156,68960,78382,74305,88811,310458
1017157,35133,32564,88371,18399,174467
1017158,33275,88270,57709,52727,231981
1017159,73525,98522,37195,85499,294741
1017160,53254,86914,92626,40793,273587
1017161,22390,79833,70269,52931,225423
1017162,5618,57404,57799,37262,158083
1017163,53895,38299,60831,23226,176251
1017164,18302,80286,7751,53745,160084
1017165,46012,7268,19337,71645,144262
1017166,25446,96035,61820,53685,236986
1017167,47581,92578,62314,66689,269162
1017168,35405,48008,11398,57303,152114
1017169,42285,49895,54377,81352,227909
1017170,29180,93905,28537,79000,230622
1017171,70266,77300,7446,61853,216865
1017172,92700,36520,37715,90895,257830
1017173,91579,28403,78516,81602,280100
1017174,67675,23361,92809,7856,191701
1017175,84135,501,79158,18663,182457
1017176,22514,28642,75485,92810,219451
1017177,11071,90923,99330,37182,238506
1017178,2039,13745,83597,55707,155088
1017179,93576,40556,62517,60471,257120
1017180,5047,22361,44186,2557,74151
1017181,35427,65134,19730,74747,195038
1017182,39691,19740,16979,49819,126229
1017183,93056,70039,75159,37673,275927
1017184,45721,87615,61759,14919,210014
1017185,22647,80835,13177,12840,129499
1017186,26263,47561,6236,55918,135978
1017187,91906,73013,59047,5758,229724
1017188,41357,97625,96431,10074,245487
1017189,3629,96584,12336,74454,187003
1017190,30883,90479,12006,67069,200437
1017191,79638,50305,73420,46627,249990
1017192,27916,67892,96814,75698,268320
1017193,9955,14545,85077,93981,203558
1017194,13915,762,26241,7890,48808
1017195,14889,88926,73225,8747,185787
1017196,62008,98699,97271,71753,329731
1017197,22266,69960,48659,21399,162284
1017198,26671,53048,57672,63099,200490
1017199,90422,32153,27020,34837,184432
1017200,33513,67893,10908,56066,168380
1017201,46522,20383,81344,27638,175887
1017202,63802,59364,16970,36305,176441
1017203,67334,11612,80916,26489,186351
1017204,36492,3036,90148,12673,142349
1017205,4041,78704,87679,43044,213468
1017206,2739,79621,13442,3386,99188
1017207,56996,2964,53290,96983,210233
1017208,38321,40224,20847,86833,186225
1017209,69587,71713,68429,54083,263812
1017210,72644,29105,52731,12497,166977
1017211,38937,22541,81912,97066,240456
1017212,98686,29835,24193,62425,215139
1017213,87578,50610,61100,73462,272750
1017214,23047,23212,60712,81408,188379
1017215,66186,38777,90520,98844,294327
1017216,71738,72306,28373,18788,191205
1017217,50712,37457,95652,12498,196319
1017218,76475,58864,96676,65136,297151
1017219,48272,29197,9188,71953,158610
1017220,82197,34846,5241,30677,152961
1017221,33230,28021,97779,45198,204228
1017222,31381,15105,44264,88491,179241
1017223,32201,2591,69786,90493,195071
1017224,55973,65611,81832,50793,254209
1017225,46133,68238,53823,44061,212255
1017226,91992,56111,4489,33020,185612
1017227,7735,95516,80393,19051,202695
1017228,36860,17013,24202,11174,89249
1017229,64820,28500,52207,76397,221924
1017230,38430,30939,57983,38930,166282
1017231,51307,16260,4803,52668,125038
1017232,1075,39911,91733,36396,169115
1017233,14215,26949,57079,40016,138259
1017234,20057,77211,45516,12149,154933
1017235,98487,30321,70398,35910,235116
1017236,65835,91832,13779,59747,231193
1017237,71230,95456,89326,30971,286983
1017238,33774,34250,14354,17140,99518
1017239,53652,39575,13956,91963,199146
1017240,75200,86010,46325,89847,297382
1017241,33892,48375,41228,33613,157108
1017242,15283,80838,10515,80866,187502
1017243,40588,18364,41718,51166,151836
1017244,91101,60440,95191,11680,258412
1017245,54712,14065,24283,56769,149829
1017246,12309,89334,22033,96449,220125
1017247,79426,87455,30791,3226,200898
1017248,89055,8050,99650,10365,207120
1017249,911,73791,22464,97802,194968
1017250,7188,91287,60487,77732,236694
1017251,95839,8697,98439,58044,261019
1017252,85770,94770,97251,86554,364345
1017253,7459,23546,36857,71134,138996
1017254,20736,51521,5877,48456,126590
1017255,47538,23932,62565,13981,148016
1017256,38402,52506,49782,17618,158308
1017257,49380,19423,78356,1347,148506
1017258,62793,76631,35630,65359,240413
1017259,75747,21222,35308,27647,159924
1017260,45251,24665,41060,93648,204624
1017261,72702,58138,79696,6546,217082
1017262,8023,38795,55249,48602,150669
1017263,15462,74619,9201,32745,132027
1017264,30135,3659,50352,35343,119489
1017265,64049,31729,73997,95745,265520
1017266,12577,47963,87318,26227,174085
1017267,64077,69942,8609,90322,232950
1017268,88397,53188,57052,60672,259309
1017269,27120,31461,10002,26398,94981
1017270,66149,71088,94248,41779,273264
1017271,42265,54870,96305,68549,261989
1017272,67137,48833,19200,54355,189525
1017273,16627,1164,87034,41400,146225
1017274,72375,30386,34177,89869,226807
1017275,65455,21286,54775,96760,238276
1017276,43136,20909,33789,93468,191302
1017277,69096,96263,9322,4788,179469
1017278,49262,46663,72433,54225,222583
1017279,52524,61792,87133,41347,242796
1017280,71087,72508,90150,68373,302118
1017281,92634,4560,74619,28283,200096
1017282,365,12228,27134,62180,101907
1017283,7300,77951,42013,57212,184476
1017284,71774,27615,35665,36037,171091
1017285,50886,2808,12546,1085,67325
1017286,95495,40246,67473,85575,288789
1017287,57730,76852,54237,28650,217469
1017288,49536,84507,36454,6804,177301
1017289,17933,39143,7999,66605,131680
1017290,52661,36449,8983,59888,157981
1017291,63179,54792,1325,98202,217498
1017292,53576,57826,32320,38198,181920
1017293,68748,71565,81629,20330,242272
1017294,50170,68632,89551,1406,209759
1017295,5961,3500,94413,20157,124031
1017296,35056,6877,35137,34849,111919
1017297,67805,96604,97973,76528,338910
1017298,12324,30814,43022,26183,112343
1017299,38191,25173,58967,84430,206761
1017300,6752,85930,92995,52539,238216
1017301,46051,7243,54287,69040,176621
1017302,91438,89992,70945,59686,312061
1017303,51589,49932,79271,7624,188416
1017304,41819,93387,23805,91527,250538
1017305,12049,66938,14009,46033,139029
1017306,39917,96112,91982,37807,265818
1017307,64253,17457,47465,51311,180486
1017308,97353,8993,39744,67523,213613
1017309,48006,23428,1499,12241,85174
1017310,83105,73,93622,57606,234406
1017311,81335,10262,83844,94358,269799
1017312,84297,40933,76019,22957,224206
1017313,27677,27592,44263,87342,186874
1017314,89837,27317,58871,71510,247535
1017315,14799,91917,72184,53449,232349
1017316,42066,16916,90932,3666,153580
1017317,49867,9454,84887,22463,166671
1017318,30625,1884,22980,34523,90012
1017319,41439,44508,9624,95479,191050
1017320,67633,77680,95532,51659,292504
1017321,26123,12086,76349,69572,184130
1017322,87062,7141,10954,2180,107337
1017323,71505,76013,9276,95639,252433
1017324,70743,45385,77562,77861,271551
1017325,136,35560,43628,68479,147803
1017326,44695,23394,66766,18021,152876
1017327,58635,49214,99944,98773,306566
1017328,35912,88353,43955,46658,214878
1017329,71723,88996,37619,18831,217169
1017330,23306,70991,53488,40212,187997
1017331,49727,57943,97284,48948,253902
1017332,71955,22453,89019,48476,231903
1017333,9630,16604,97966,36678,160878
1017334,29955,59201,21723,44961,155840
1017335,12422,5844,39493,75587,133346
1017336,60736,25074,32080,8509,126399
1017337,97512,61821,47756,19747,226836
1017338,43872,53678,33980,66638,198168
1017339,35177,6103,60772,45004,147056
1017340,38061,6367,66209,1646,112283
1017341,53827,93270,14490,4918,166505
1017342,26723,62796,64927,12423,166869
1017343,83522,74904,4751,14251,177428
1017344,49897,48696,70256,48727,217576
1017345,53803,95377,5897,46206,201283
1017346,46702,5261,58108,92874,202945
1017347,63217,71530,17751,51041,203539
1017348,22576,98603,91370,84087,296636
1017349,66713,76372,88186,55092,286363
1017350,47002,57286,98355,17709,220352
1017351,60327,77846,39946,504,178623
1017352,16716,40910,38154,11534,107314
1017353,84792,37616,4240,54574,181222
1017354,51584,43991,10465,66434,172474
1017355,43100,89070,24536,87018,243724
1017356,66833,1292,37691,25996,131812
1017357,4210,98023,19607,91054,212894
1017358,40278,29963,60830,28920,159991
1017359,44086,65415,37262,23023,169786
1017360,69555,64331,74893,22602,231381
1017361,50699,87907,29952,94183,262741
1017362,43782,22533,4895,6307,77517
1017363,18586,88289,90887,78287,276049
1017364,65082,8215,69006,33047,175350
1017365,40401,52337,73253,30153,196144
1017366,79165,7814,40270,9423,136672
1017367,79577,94119,9688,39789,223173
1017368,19231,65874,14293,86268,185666
1017369,5694,6256,4096,33055,49101
1017370,83688,41553,5577,8242,139060
1017371,42954,87263,3675,9782,143674
1017372,52515,52979,40888,33431,179813
1017373,66504,42208,16516,25392,150620
1017374,99943,54378,92081,35500,281902
1017375,74262,36139,64559,60140,235100
1017376,96959,76591,2352,9025,184927
1017377,33825,92913,89788,89831,306357
1017378,81805,24555,7901,5819,120080
1017379,636,59214,95111,95092,250053
1017380,44309,68720,26247,34933,174209
1017381,30850,96015,72512,8482,207859
1017382,75591,67364,73659,48430,265044
1017383,94495,51098,14194,4497,164284
1017384,48806,6627,14329,54865,124627
1017385,94427,12689,37513,47797,192426
1017386,18820,11010,73952,55517,159299
1017387,32662,22410,42689,28803,126564
1017388,59671,86975,11187,74680,232513
1017389,6316,60262,35674,47194,149446
1017390,2118,33945,40024,85604,161691
1017391,99422,26359,86017,33115,244913
1017392,61460,40931,65295,63795,231481
1017393,43331,69236,90978,95268,298813
1017394,7599,24885,56540,76618,165642
1017395,19622,95222,16086,78453,209383
1017396,11823,65220,31771,31270,140084
1017397,1984,20002,9177,78702,109865
1017398,23319,22569,81516,75624,203028
1017399,24166,65720,32578,70587,193051
1017400,68342,95417,3879,52506,220144
1017401,74635,97513,4029,73193,249370
1017402,22572,20090,35864,5598,84124
1017403,1596,3833,37486,99347,142262
1017404,22722,43854,6483,12110,85169
1017405,57478,26085,12399,35394,131356
1017406,63434,2869,81959,42214,190476
1017407,40967,45520,31875,21781,140143
1017408,56892,73356,55676,60147,246071
1017409,19217,84287,9916,73335,186755
1017410,36087,73439,80743,68726,258995
1017411,41496,72416,97299,4558,215769
1017412,44607,36240,71792,79818,232457
1017413,20649,70683,1348,42727,135407
1017414,12453,92992,58655,92266,256366
1017415,48832,33450,98734,24019,205035
1017416,60900,8816,7292,15361,92369
1017417,20568,75286,48306,38303,182463
1017418,7255,89377,2529,23386,122547
1017419,43684,14761,7916,91761,158122
1017420,29311,23003,86949,19468,158731
1017421,56051,13480,50097,93029,212657
1017422,46482,40475,93010,56961,236928
1017423,36445,16198,6324,82802,141769
1017424,48023,81514,43848,1757,175142
1017425,2417,48854,9552,79980,140803
1017426,86581,82681,97250,50497,317009
1017427,32763,18552,84817,4943,141075
1017428,33207,61075,86558,6793,187633
1017429,31942,68979,97241,92948,291110
1017430,47994,59096,16708,49974,173772
1017431,68667,5697,16840,61041,152245
1017432,24551,82460,65928,34080,207019
1017433,8198,36563,89711,36715,171187
1017434,40974,83740,38599,59640,222953
1017435,9145,98011,84350,50708,242214
1017436,54008,38430,6974,14117,113529
1017437,35956,81859,29529,60540,207884
1017438,26888,63866,23792,70962,185508
1017439,91251,94650,75630,19096,280627
1017440,66680,55962,88122,16658,227422
1017441,27836,43063,98743,20114,189756
1017442,19268,51911,5902,70888,147969
1017443,18819,87931,88813,84084,279647
1017444,59247,34694,95292,30226,219459
1017445,51622,80280,92287,27998,252187
1017446,15380,3083,11814,93408,123685
1017447,33094,41692,10533,91510,176829
1017448,23303,20987,41269,66044,151603
1017449,22228,22259,66687,90451,201625
1017450,30457,32568,5606,13571,82202
1017451,49706,18869,53800,65081,187456
1017452,65064,48225,72077,99111,284477
1017453,66999,45779,82284,97938,293000
1017454,62457,32348,55071,68394,218270
1017455,53347,18525,80647,10904,163423
1017456,37683,26920,7184,94439,166226
1017457,25654,62965,31944,50027,170590
1017458,58751,44842,8409,44261,156263
1017459,44375,16718,36798,93981,191872
1017460,14613,44935,81525,58654,199727
1017461,35995,96768,58815,71559,263137
1017462,94518,23197,66899,51259,235873
1017463,32115,45593,63834,52665,194207
1017464,85215,46289,55879,96173,283556
1017465,98859,40781,96741,90249,326630
1017466,36418,59026,46473,36576,178493
1017467,39821,53379,625,25282,119107
1017468,29330,5136,88679,9410,132555
1017469,69586,1287,59166,80099,210138
1017470,49437,67413,51678,5594,174122
1017471,77229,15562,45600,37090,175481
1017472,50788,12923,4371,3773,71855
1017473,81466,87042,26516,91074,286098
1017474,55593,76176,3837,79107,214713
1017475,73737,19023,99316,48932,241008
1017476,38221,89815,78123,52759,258918
1017477,63852,43333,16916,43714,167815
1017478,67636,14520,33285,93103,208544
1017479,78734,45800,59714,60193,244441
1017480,12898,80881,61731,26031,181541
1017481,56746,75512,93612,29630,255500
1017482,80572,54091,28314,68645,231622
1017483,59251,86906,67600,30283,244040
1017484,55689,21562,14289,87743,179283
1017485,54075,4758,75298,75962,210093
1017486,24194,33823,96050,3400,157467
1017487,26448,92853,47856,21770,188927
1017488,83792,93103,41637,63123,281655
1017489,7883,8120,78799,29648,124450
1017490,77604,25774,17187,31280,151845
1017491,45126,12856,44930,24914,127826
1017492,12489,50020,41831,21529,125869
1017493,17600,67078,78537,71892,235107
1017494,42974,43733,57755,71015,215477
1017495,19405,48045,56454,11926,135830
1017496,56528,1348,55301,75296,188473
1017497,58969,18990,33525,14125,125609
1017498,86737,34060,32849,71375,225021
1017499,47528,92685,67528,50148,257889
1017500,44358,75350,20077,37547,177332
1017501,31264,25804,93775,3595,154438
1017502,73880,82120,91127,27817,274944
1017503,16437,21180,15712,30192,83521
1017504,22517,74692,1328,84274,182811
1017505,67789,94035,57988,70175,289987
1017506,66133,25648,15129,20726,127636
1017507,50108,1104,47359,63305,161876
1017508,4109,82996,78255,74651,240011
1017509,69107,77460,27976,25997,200540
1017510,66155,94158,82596,12991,255900
1017511,2277,49457,76781,5863,134378
1017512,18451,19462,56640,91363,185916
1017513,83779,51497,74472,54252,264000
1017514,59858,37218,34581,46048,177705
1017515,91738,61196,24986,93643,271563
1017516,48231,33293,49120,48223,178867
1017517,31378,54839,26007,45244,157468
1017518,56715,96300,11350,64805,229170
1017519,82978,66612,60587,6387,216564
1017520,41561,14441,63781,26761,146544
1017521,6715,57562,19956,30957,115190
1017522,74925,18007,23612,79696,196240
1017523,46564,68788,19055,86860,221267
1017524,8045,96567,95727,81478,281817
1017525,56821,26324,33753,12197,129095
1017526,95825,11069,90187,67323,264404
1017527,6093,94626,9698,78413,188830
1017528,43321,54175,5312,50469,153277
1017529,95783,81556,19562,56205,253106
1017530,58973,1855,57981,97270,216079
1017531,79108,58038,42093,40388,219627
1017532,80207,6903,71037,26033,184180
1017533,704,83684,8242,45913,138543
1017534,56632,66108,31868,58134,212742
1017535,17325,57730,91244,78361,244660
1017536,17462,39578,41826,63055,161921
1017537,33165,72605,97374,62251,265395
1017538,8524,53557,78687,17604,158372
1017539,7125,62890,90700,66913,227628
1017540,70866,34247,89980,6125,201218
1017541,69955,90761,50326,80005,291047
1017542,93223,56266,89062,84961,323512
1017543,47487,72486,54712,16164,190849
1017544,54036,67946,21712,31335,175029
1017545,41385,41343,36894,56848,176470
1017546,43005,13729,88276,45353,190363
1017547,84288,56363,29332,6185,176168
1017548,78476,55521,57443,51203,242643
1017549,69042,23969,98446,8909,200366
1017550,69172,83785,55133,64289,272379
1017551,95823,27399,40986,33990,198198
1017552,39251,14802,13837,69835,137725
1017553,85092,33676,32241,56173,207182
1017554,3829,30066,421,91774,126090
1017555,16190,1345,4501,61718,83754
1017556,42752,95754,66783,88763,294052
1017557,53058,49556,49765,83777,236156
1017558,530,83834,55784,65980,206128
1017559,88167,26138,58903,42097,215305
1017560,62075,23434,86927,63541,235977
1017561,84102,12933,74951,83549,255535
1017562,67443,49113,12859,38632,168047
1017563,94058,88837,95664,32745,311304
1017564,20883,42631,15950,57410,136874
1017565,51301,45437,87315,65473,249526
1017566,8783,50802,36573,24513,120671
1017567,82235,98902,77212,91773,350122
1017568,52754,54275,80632,53809,241470
1017569,36713,44024,12917,3814,97468
1017570,47592,91484,29368,52921,221365
1017571,5503,40336,16260,40770,102869
1017572,8877,93311,115,44992,147295
1017573,9237,21776,96081,88337,215431
1017574,14954,93475,79724,7203,195356
1017575,19855,52234,65897,22170,160156
1017576,70865,28978,21667,90334,211844
1017577,63156,50912,16354,2741,133163
1017578,73244,66169,74755,13429,227597
1017579,24927,71758,66211,19484,182380
1017580,78017,12726,84463,89776,264982
1017581,45650,74553,99870,21476,241549
1017582,56103,37432,22506,87516,203557
1017583,14232,5097,81271,12528,113128
1017584,42192,92280,1483,24437,160392
1017585,44116,6188,15146,12069,77519
1017586,57409,66132,44634,67785,235960
1017587,71109,66461,5787,7308,150665
1017588,51723,13740,92118,46331,203912
1017589,37089,3268,46711,57448,144516
1017590,80836,3809,996,33334,118975
1017591,47637,49604,8383,34377,140001
1017592,10505,74205,7205,92113,184028
1017593,44118,96143,70833,40443,251537
1017594,20885,89210,63855,1473,175423
1017595,73096,18115,35587,34438,161236
1017596,37640,51447,90285,12186,191558
1017597,97362,8413,40278,97039,243092
1017598,23233,57586,22330,21205,124354
1017599,3554,42213,67033,14050,126850
1017600,40697,83413,21477,25027,170614
1017601,82506,77475,89233,27286,276500
1017602,2447,80795,66578,86087,235907
1017603,62917,77459,76069,82921,299366
1017604,46482,28239,60714,15415,150850
1017605,87913,96280,48293,10157,242643
1017606,11577,14806,87676,832,114891
1017607,78606,92551,40284,34858,246299
1017608,51096,48706,58635,90197,248634
1017609,74541,64178,69704,19692,228115
1017610,94945,95300,51967,66152,308364
1017611,74717,69146,82655,19434,245952
1017612,44749,93704,26159,44129,208741
1017613,50550,83757,17491,75515,227313
1017614,19925,31198,83049,70334,204506
1017615,83240,45215,62441,53752,244648
1017616,54308,54532,58785,74472,242097
1017617,37076,5327,29461,47046,118910
1017618,31686,1335,32909,12140,78070
1017619,17663,1123,33946,94400,147132
1017620,38674,40787,12198,15040,106699
1017621,37725,7775,91017,75999,212516
1017622,29156,52870,25266,58791,166083
1017623,94964,95364,2841,52015,245184
1017624,16977,17938,61354,34622,130891
1017625,8803,79653,7489,5966,101911
1017626,84679,37321,34047,13661,169708
1017627,26993,25286,89678,17942,159899
1017628,63418,50221,17019,8501,139159
1017629,81180,12308,80547,99329,273364
1017630,22936,69695,11514,29217,133362
1017631,19889,95017,43938,72512,231356
1017632,69843,9428,50566,29854,159691
1017633,59471,18459,40556,94404,212890
1017634,44059,96199,61447,31145,232850
1017635,25375,39182,77183,25733,167473
1017636,37368,68438,59554,58041,223401
1017637,52768,31849,9960,74357,168934
1017638,7370,24653,58979,21558,112560
1017639,28461,26297,27181,35466,117405
1017640,83946,83397,19020,9481,195844
1017641,55949,25006,5530,51007,137492
1017642,82087,98634,96090,6322,283133
1017643,12293,29633,64302,65684,171912
1017644,63244,67085,64813,273,195415
1017645,98204,55176,19148,85886,258414
1017646,47080,60284,93811,37287,238462
1017647,10088,69003,95280,38634,213005
1017648,40820,63849,13614,68124,186407
1017649,83089,66097,44224,74182,267592
1017650,40315,82415,22571,708,146009
1017651,55381,58688,21232,62133,197434
1017652,99232,62617,22971,62134,246954
1017653,97478,94912,55428,71252,319070
1017654,64137,14732,88747,88698,256314
1017655,389,6356,60432,11909,79086
1017656,19773,82023,63558,13976,179330
1017657,31866,7801,99191,78436,217294
1017658,952,84634,67330,74756,227672
1017659,49111,91003,79209,37465,256788
1017660,28910,86220,12899,93766,221795
1017661,29520,54274,20069,84500,188363
1017662,20197,189,87972,44537,152895
1017663,69852,71576,66613,39823,247864
1017664,65583,7069,67169,67526,207347
1017665,38495,8159,91743,62475,200872
1017666,47120,39866,11389,40001,138376
1017667,56739,61599,71638,73729,263705
1017668,80457,32030,18689,16419,147595
1017669,62280,56457,37627,49219,205583
1017670,11761,60333,28739,66927,167760
1017671,54499,29177,93356,98466,275498
1017672,49078,9546,21257,85792,165673
1017673,10606,39741,72777,95744,218868
1017674,51418,33829,96706,24412,206365
1017675,15816,9015,93446,96967,215244
1017676,27421,58046,45623,61452,192542
1017677,65864,5904,61259,85408,218435
1017678,53628,30197,53275,28774,165874
1017679,96236,31258,74807,1842,204143
1017680,32597,92800,88748,51533,265678
1017681,3565,59778,94539,68957,226839
1017682,66542,4781,2669,33110,107102
1017683,1871,76179,40942,80391,199383
1017684,38776,90784,58348,18781,206689
1017685,16841,17832,49788,50229,134690
1017686,39829,9038,51815,15465,116147
1017687,24458,2640,27179,23246,77523
1017688,13343,86311,45347,97133,242134
1017689,48812,91278,43214,62085,245389
1017690,54335,13879,65228,84177,217619
1017691,65329,71598,41342,94047,272316
1017692,97702,68067,95017,25760,286546
1017693,50448,36185,54572,92840,234045
1017694,55213,72978,98676,50038,276905
1017695,914,85724,25443,57542,169623
1017696,23068,83546,13411,65490,185515
1017697,30680,21931,56983,8444,118038
1017698,88925,31562,30874,7555,158916
1017699,92652,76380,51532,53507,274071
1017700,63267,86139,8629,57882,215917
1017701,66084,22947,71956,95056,256043
1017702,5216,82370,72448,49095,209129
1017703,88441,94653,83023,98016,364133
1017704,58232,75109,53249,63934,250524
1017705,86845,72297,45016,31348,235506
1017706,6956,85891,77377,53876,224100
1017707,85506,28280,91094,59603,264483
1017708,71904,69535,89831,1935,233205
1017709,72650,17015,38097,79425,207187
1017710,84103,65773,74150,83965,307991
1017711,66947,7404,60508,95101,229960
1017712,39515,63315,17308,51066,171204
1017713,89928,7060,12344,73314,182646
1017714,51430,28064,94725,13912,188131
1017715,14742,23736,34889,47256,120623
1017716,12680,43268,64022,62613,182583
1017717,15356,58209,71852,71493,216910
1017718,15207,22819,32890,94099,165015
1017719,39115,33966,39714,7153,119948
1017720,10887,8713,37872,93193,150665
1017721,45030,59498,12752,66803,184083
1017722,40938,74408,39114,16572,171032
1017723,44357,77383,64284,54691,240715
1017724,68137,74466,50925,23159,216687
1017725,88879,1745,60008,1467,152099
1017726,84836,1447,71139,46706,204128
1017727,26127,1900,81384,95282,204693
1017728,53455,40526,67326,37171,198478
1017729,90340,83209,93054,31327,297930
1017730,47537,91366,98095,84468,321466
1017731,12634,58646,46825,66109,184214
1017732,37702,14935,40557,7677,100871
1017733,31746,63013,92684,48807,236250
1017734,30888,92304,41813,87228,252233
1017735,24815,73131,56632,93199,247777
1017736,36319,4989,14206,70954,126468
1017737,73464,26860,8908,80534,189766
1017738,95805,23156,56331,92923,268215
1017739,98752,38633,91146,99990,328521
1017740,2393,47646,53415,64143,167597
1017741,32534,596,87772,60754,181656
1017742,12395,2754,68198,8429,91776
1017743,37076,76403,28307,35208,176994
1017744,56289,37569,63031,39710,196599
1017745,35001,2116,88625,99212,224954
1017746,48406,82205,35993,31750,198354
1017747,55010,86471,26263,37554,205298
1017748,66904,96732,15603,32330,211569
1017749,71638,11066,32753,19111,134568
1017750,16390,40233,78797,60255,195675
1017751,74462,34736,58510,57932,225640
1017752,18411,58003,51819,25383,153616
1017753,79426,6137,55203,93148,233914
1017754,45275,63224,70433,89104,268036
1017755,89519,90680,81591,50113,311903
1017756,78828,61741,29993,16907,187469
1017757,92534,42280,36633,73805,245252
1017758,95229,12719,99995,46269,254212
1017759,91918,42653,22202,46471,203244
1017760,94794,91043,14503,16836,217176
1017761,81779,97705,27515,34443,241442
1017762,29243,97890,45675,37929,210737
1017763,68797,80361,59027,88410,296595
1017764,96185,82134,60593,79922,318834
1017765,79209,82311,31007,60605,253132
1017766,56188,32564,56126,31020,175898
1017767,39079,2695,52788,29620,124182
1017768,78852,56201,18247,6700,160000
1017769,94649,5329,1950,94737,196665
1017770,58321,93880,80763,40317,273281
1017771,45778,42703,97321,71844,257646
1017772,96513,72992,61277,73506,304288
1017773,84966,74591,48377,95984,303918
1017774,18227,7444,19508,47212,92391
1017775,82476,94898,51323,81227,309924
1017776,13652,80926,27256,76724,198558
1017777,22542,88530,67093,84704,262869
1017778,89893,59080,16969,27724,193666
1017779,40395,32381,92969,6583,172328
1017780,74736,91630,46747,57892,271005
1017781,49930,62671,54882,70641,238124
1017782,50248,79218,2062,33987,165515
1017783,15156,78196,20530,88565,202447
1017784,9202,77345,14591,32982,134120
1017785,14806,92853,24867,27247,159773
1017786,36681,31641,5597,8688,82607
1017787,23613,91323,20478,90806,226220
1017788,83416,62550,16376,92170,254512
1017789,39068,64941,24260,70480,198749
1017790,56376,45004,33422,86778,221580
1017791,77976,59554,16617,74714,228861
1017792,97412,34346,30917,38088,200763
1017793,78718,89482,17786,75289,261275
1017794,93888,2013,51644,53673,201218
1017795,3724,3613,19325,94376,121038
1017796,89413,61275,71650,8085,230423
1017797,94214,80887,55376,12291,242768
1017798,5146,2314,57689,16346,81495
1017799,98487,51433,26909,46335,223164
1017800,27714,82270,54331,62714,227029
1017801,6954,70740,91652,74356,243702
1017802,21463,67637,67515,17491,174106
1017803,46468,58539,52634,30329,187970
1017804,40166,80183,53681,32342,206372
1017805,85700,82195,58014,90417,316326
1017806,98302,65049,85596,19165,268112
1017807,90325,28712,54116,6570,179723
1017808,20617,75740,25945,95488,217790
1017809,82681,66744,70896,73811,294132
1017810,10664,23315,33237,78453,145669
1017811,7030,34141,73081,99112,213364
1017812,30224,51991,51975,27779,161969
1017813,35717,82852,67649,93001,279219
1017814,53646,78004,89516,56091,277257
1017815,88337,54486,64872,45108,252803
1017816,93785,38156,42470,38531,212942
1017817,18569,32635,88966,96809,236979
1017818,11232,5298,99207,26370,142107
1017819,66866,57154,72445,84795,281260
1017820,49524,45459,83188,44404,222575
1017821,49182,41494,45299,83477,219452
1017822,66046,89522,41861,2177,199606
1017823,44801,76311,50623,60533,232268
1017824,88773,83385,22967,45226,240351
1017825,21083,56920,83246,4319,165568
1017826,94965,109,95842,35858,226774
1017827,25227,39043,86,81865,146221
1017828,25199,47051,50150,94491,216891
1017829,64698,29669,96713,61296,252376
1017830,87071,64233,26960,17466,195730
1017831,47474,62972,55165,54085,219696
1017832,59598,67093,97995,55709,280395
1017833,66531,54984,72384,44929,238828
1017834,41360,62798,90317,83740,278215
1017835,13789,22320,11345,64151,111605
1017836,65011,75624,37018,88477,266130
1017837,73136,77394,64742,69760,285032
1017838,36867,94176,30195,55929,217167
1017839,91493,41195,29359,77232,239279
1017840,39712,23978,2425,74981,141096
1017841,26385,58678,31035,98119,214217
1017842,82675,56503,26620,4009,169807
1017843,95412,88194,13633,76613,273852
1017844,69520,77018,64535,47149,258222
1017845,23797,87338,53380,44892,209407
1017846,14283,92475,58784,90883,256425
1017847,23819,64833,65444,94183,248279
1017848,54926,60764,8848,76679,201217
1017849,80392,72004,28297,13223,193916
1017850,10409,70843,57574,94121,232947
1017851,38692,86045,52312,56127,233176
1017852,74237,14246,84242,10212,182937
1017853,51329,25893,44887,66778,188887
1017854,13919,29725,16138,30456,90238
1017855,19465,26590,56815,70764,173634
1017856,73928,94072,59167,59728,286895
1017857,76988,93826,29445,23296,223555
1017858,81616,2038,50569,81301,215524
1017859,81675,42943,84011,52586,261215
1017860,89868,73310,33725,22079,218982
1017861,62523,3568,22830,67175,156096
1017862,82082,58372,78694,19462,238610
1017863,35109,96710,49865,48492,230176
1017864,57791,34762,83066,78479,254098
1017865,85064,90166,40239,29803,245272
1017866,38752,9094,56579,63609,168034
1017867,4038,93849,26010,84940,208837
1017868,6588,18681,14560,96426,136255
1017869,16049,24326,7117,86201,133693
1017870,29735,24617,72288,42947,169587
1017871,3631,72086,46489,74979,197185
1017872,40149,23634,35422,61405,160610
1017873,79612,54970,63375,71224,269181
1017874,71432,37028,55078,91815,255353
1017875,4938,59267,83999,16154,164358
1017876,40427,7868,23751,24409,96455
1017877,82530,91356,66274,82998,323158
1017878,46918,93990,41747,9483,192138
1017879,80329,71963,11758,43633,207683
1017880,27068,81204,70901,14691,193864
1017881,70840,11957,76088,71447,230332
1017882,81624,90002,2443,17296,191365
1017883,94435,20486,39075,59010,213006
1017884,76348,95080,93585,80571,345584
1017885,5592,3835,24789,63512,97728
1017886,51745,1561,60759,74438,188503
1017887,45163,18857,57724,48334,170078
1017888,8118,1338,48020,39078,96554
1017889,19016,39644,83323,2197,144180
1017890,88550,67328,39859,44578,240315
1017891,22095,36332,76179,278,134884
1017892,21947,76490,39708,92802,230947
1017893,52754,30217,16213,36240,135424
1017894,29743,15828,92948,21877,160396
1017895,69723,16523,7681,50717,144644
1017896,88484,99078,79015,88739,355316
1017897,14277,39001,72027,70055,195360
1017898,53926,3297,4230,9590,71043
1017899,32286,37784,6844,68176,145090
1017900,22103,86327,61839,13683,183952
1017901,87523,97578,31950,76153,293204
1017902,39950,77593,96662,25875,240080
1017903,96840,16708,5102,23237,141887
1017904,42405,59148,8657,43371,153581
1017905,10919,20803,90904,84195,206821
1017906,92532,63688,84384,65556,306160
1017907,11781,86782,88498,34029,221090
1017908,88254,93753,43843,59072,284922
1017909,46327,57898,74735,74896,253856
1017910,77966,79659,2320,26744,186689
1017911,12897,75158,83559,68252,239866
1017912,98115,74139,17376,61669,251299
1017913,14968,75975,91502,57278,239723
1017914,42255,76698,34942,41179,195074
1017915,33276,77626,49305,81838,242045
1017916,56681,82865,46876,36702,223124
1017917,75885,42111,13336,72179,203511
1017918,94245,8205,45542,56159,204151
1017919,98804,69903,31916,21744,222367
1017920,32628,68624,95675,63512,260439
1017921,68499,12535,70308,76041,227383
1017922,38847,62117,72980,26786,200730
1017923,45492,78166,42149,18638,184445
1017924,28167,99812,72260,24653,224892
1017925,78874,2406,15897,72430,169607
1017926,4260,30787,62910,53842,151799
1017927,39314,42311,70131,63271,215027
1017928,1103,72974,44815,34104,152996
1017929,77007,24091,76205,71508,248811
1017930,19237,48057,68323,18065,153682
1017931,29535,37455,3359,24333,94682
1017932,1481,85528,91692,27303,206004
1017933,77605,56537,78731,41804,254677
1017934,99287,11688,32737,16920,160632
1017935,47786,74730,44593,79729,246838
1017936,37667,16937,56038,69585,180227
1017937,31294,58366,67922,30119,187701
1017938,64076,78789,256,68248,211369
1017939,9200,70397,64130,75855,219582
1017940,66076,80322,75633,62561,284592
1017941,51616,13690,37794,72032,175132
1017942,27202,85866,11332,17102,141502
1017943,71530,57867,38916,73932,242245
1017944,54589,91837,97477,56497,300400
1017945,28779,54992,7430,61917,153118
1017946,13370,5327,95596,51192,165485
1017947,43884,48989,93229,62713,248815
1017948,155,6085,22291,75848,104379
1017949,30725,4367,86595,73331,195018
1017950,18387,40427,87449,71652,217915
1017951,67101,49502,61146,52899,230648
1017952,21419,16833,70510,98448,207210
1017953,9253,98053,57342,84267,248915
1017954,52150,73592,86420,70698,282860
1017955,56493,24209,26363,43309,150374
1017956,35968,68584,47343,93123,245018
1017957,46432,36508,76180,37537,196657
1017958,11679,47193,37394,17067,113333
1017959,32075,43883,84979,37676,198613
1017960,52686,15128,46053,41610,155477
1017961,22470,95315,9382,52593,179760
1017962,96947,33227,28138,44305,202617
1017963,80139,75554,36877,66011,258581
1017964,85177,93409,99683,62249,340518
1017965,9314,81881,60297,76596,228088
1017966,5244,95093,42074,42262,184673
1017967,85793,99343,80253,18636,284025
1017968,55057,24105,14213,93721,187096
1017969,11641,51415,85217,59313,207586
1017970,76310,73448,80991,24708,255457
1017971,90441,67437,56080,98986,312944
1017972,64377,59854,30728,73470,228429
1017973,54510,40769,48609,22890,166778
1017974,54587,54903,82167,5124,196781
1017975,2778,57624,7483,12009,79894
1017976,4077,77358,74261,74149,229845
1017977,96218,21337,91064,6396,215015
1017978,28399,68389,31548,52304,180640
1017979,8612,4996,98523,36530,148661
1017980,24337,52535,87345,24047,188264
1017981,18775,83907,28870,58199,189751
1017982,36237,12480,16122,48007,112846
1017983,59108,69861,54408,66075,249452
1017984,65281,10145,66374,40645,182445
1017985,95768,62656,85482,34824,278730
1017986,45977,65546,68071,62486,242080
1017987,91550,30893,67896,71918,262257
1017988,21755,91485,53514,78487,245241
1017989,82149,52071,73863,930,209013
1017990,31061,30800,89054,87767,238682
1017991,18719,52214,62231,77216,210380
1017992,94803,2652,17225,70321,185001
1017993,2872,13599,13998,34460,64929
1017994,44919,73918,69884,56778,245499
1017995,67491,4196,18582,56370,146639
1017996,73161,67614,81033,22403,244211
1017997,37526,41205,54560,85720,219011
1017998,35333,51093,50637,23202,160265
1017999,84695,30772,11305,67881,194653
1018000,16799,99484,21840,81657,219780
1018001,33461,14265,13478,8060,69264
1018002,28901,25188,73060,43381,170530
1018003,66302,72546,20205,15078,174131
1018004,11254,31135,75579,1725,119693
1018005,85600,15068,15466,11284,127418
1018006,28063,22401,24834,17601,92899
1018007,55223,66561,80876,18747,221407
1018008,37764,52419,49918,66193,206294
1018009,78448,2036,44438,57897,182819
1018010,61193,73850,84522,33686,253251
1018011,40652,55353,41469,5559,143033
1018012,65210,27533,38441,10178,141362
1018013,73596,83058,85068,92141,333863
1018014,47988,18863,70230,95840,232921
1018015,88332,7004,92911,90031,278278
1018016,10524,37842,75863,68280,192509
1018017,69387,1526,87000,90915,248828
1018018,76337,70889,98782,70240,316248
1018019,6793,72837,84341,44574,208545
1018020,55869,84244,21001,64179,225293
1018021,34620,95809,60300,25421,216150
1018022,19893,99425,91814,70504,281636
1018023,49907,7273,95688,87389,240257
1018024,94321,1102,89944,3260,188627
1018025,59367,44126,25607,69186,198286
1018026,80846,1425,81569,54897,218737
1018027,35252,62204,40864,45193,183513
1018028,16880,59611,78372,24959,179822
1018029,81857,34013,51719,17277,184866
1018030,10487,76147,60246,11646,158526
1018031,1425,63422,1986,81507,148340
1018032,30278,84529,53583,82828,251218
1018033,25136,2081,15808,94990,138015
1018034,12669,33093,9153,51467,106382
1018035,32375,6633,21644,85930,146582
1018036,1149,59511,40698,57934,159292
1018037,4940,79904,83454,95195,263493
1018038,7921,12318,31973,24480,76692
1018039,54149,29893,21996,73452,179490
1018040,54446,52728,77604,62104,246882
1018041,20265,13382,61109,71871,166627
1018042,91058,74110,20781,39472,225421
1018043,28760,44283,89689,54977,217709
1018044,1295,45857,68867,7375,123394
1018045,35933,14836,20496,34389,105654
1018046,59823,50522,51219,4134,165698
1018047,94851,14149,26156,27606,162762
1018048,13046,27386,96557,63681,200670
1018049,25171,40219,76270,34298,175958
1018050,30898,9615,35026,81110,156649
1018051,95101,61372,16454,15389,188316
1018052,78907,35799,66386,61916,243008
1018053,54253,97631,24229,50568,226681
1018054,14424,96657,68796,38964,218841
1018055,7095,92703,26719,77226,203743
1018056,28813,41135,25371,67128,162447
1018057,69522,45318,43195,41868,199903
1018058,81647,28414,77758,63466,251285
1018059,6162,53980,16937,90617,167696
1018060,34517,87754,25345,82646,230262
1018061,80610,29475,17219,1897,129201
1018062,40659,56916,13989,40306,151870
1018063,45141,52209,30501,71353,199204
1018064,35474,92469,29604,83362,240909
1018065,97300,81094,20131,72110,270635
1018066,25790,44427,67975,4376,142568
1018067,46258,40704,88090,26787,201839
1018068,17046,33618,73839,89014,213517
1018069,8340,86296,45869,93894,234399
1018070,51871,90929,81294,22147,246241
1018071,16524,11561,39137,98121,165343
1018072,19270,4112,82974,60301,166657
1018073,51075,31412,35764,92394,210645
1018074,35375,69774,30079,12719,147947
1018075,96889,43338,42988,37581,220796
1018076,42613,27071,44762,56047,170493
1018077,71920,47813,38114,72783,230630
1018078,23208,54738,42792,69009,189747
1018079,36107,74667,40610,34438,185822
1018080,14623,84160,51112,12315,162210
1018081,89035,26026,19995,57332,192388
1018082,28684,7741,36107,51862,124394
1018083,59213,19653,79961,91650,250477
1018084,58131,56569,17145,12778,144623
1018085,14384,53644,54348,15107,137483
1018086,23328,40199,26504,38545,128576
1018087,99164,78667,3151,73859,254841
1018088,55599,27920,54666,47639,185824
1018089,63065,34709,99345,57330,254449
1018090,22775,37818,53291,70237,184121
1018091,67218,15468,16440,61233,160359
1018092,82719,93501,94946,33970,305136
1018093,31745,67339,65783,12470,177337
1018094,41190,4237,67644,85579,198650
1018095,52333,3064,90551,73024,218972
1018096,10499,51707,34711,19714,116631
1018097,31558,74894,36158,92093,234703
1018098,65665,57799,50774,60856,235094
1018099,91928,60687,9083,6125,167823
1018100,9614,39936,89159,71008,209717
1018101,74526,86225,11257,17549,189557
1018102,15621,77549,47036,75427,215633
1018103,25708,33258,46350,39767,145083
1018104,37730,33361,56817,29542,157450
1018105,14496,99305,98387,49124,261312
1018106,464,69723,83835,78532,232554
1018107,85785,59492,4579,60343,210199
1018108,94384,636,20935,54095,170050
1018109,65797,46902,37269,29203,179171
1018110,24130,41405,55498,87905,208938
1018111,35448,81189,96172,86054,298863
1018112,36254,15962,36242,35453,123911
1018113,17734,39758,74241,48079,179812
1018114,24060,39551,10613,81283,155507
1018115,34873,36443,8660,82837,162813
1018116,62448,38841,58195,13648,173132
1018117,62443,92194,91047,2332,248016
1018118,46150,13090,33678,35959,128877
1018119,64540,60287,24038,54202,203067
1018120,42785,62158,54494,78631,238068
1018121,27385,96422,30366,10064,164237
1018122,45596,69508,4250,48114,167468
1018123,80396,86739,81628,35090,283853
1018124,96442,92019,83787,25170,297418
1018125,66717,96206,28955,6854,198732
1018126,84661,48382,72891,2095,208029
1018127,10421,24146,52121,98866,185554
1018128,89542,17328,43273,27491,177634
1018129,46634,93220,79889,42179,261922
1018130,57303,55252,31753,86184,230492
1018131,94769,15041,80047,14567,204424
1018132,43167,43403,79587,5133,171290
1018133,8198,6604,31785,13408,59995
1018134,57760,53323,43833,50023,204939
1018135,96716,4306,90091,45630,236743
1018136,53944,5223,20439,20498,100104
1018137,13949,34031,55811,89558,193349
1018138,12167,6222,55144,46615,120148
1018139,53687,28612,77948,90966,251213
1018140,84447,55383,31310,75028,246168
1018141,78756,19310,59173,64032,221271
1018142,89297,73295,61551,12472,236615
1018143,52236,20892,14866,91783,179777
1018144,99729,18746,62943,73498,254916
1018145,79243,67219,2715,88037,237214
1018146,45276,97068,76456,66963,285763
1018147,92270,46759,43506,55864,238399
1018148,15222,12235,82117,41106,150680
1018149,24965,99311,47486,75708,247470
1018150,20894,69073,65416,52348,207731
1018151,62344,84486,91681,79313,317824
1018152,47517,93728,44266,10515,196026
1018153,19987,89140,20062,88002,217191
1018154,53922,14266,11737,86622,166547
1018155,19429,8304,19255,65904,112892
1018156,39116,15760,30850,93208,178934
1018157,24114,30056,59170,90444,203784
1018158,44110,7886,46147,13382,111525
1018159,65242,81604,28976,10748,186570
1018160,57108,50776,27736,33360,168980
1018161,10310,64563,93382,53780,222035
1018162,34015,6581,23538,41304,105438
1018163,11563,31229,25056,93885,161733
1018164,92318,25526,48965,16572,183381
1018165,31099,67405,39589,70928,209021
1018166,62946,47688,53544,80336,244514
1018167,15875,9735,99488,13318,138416
1018168,37605,29850,35117,69139,171711
1018169,76378,84144,49128,55456,265106
1018170,3683,52487,77106,78144,211420
1018171,45136,50359,49985,94197,239677
1018172,89911,90229,7744,26305,214189
1018173,51527,22153,85991,57981,217652
1018174,13287,34417,74367,65463,187534
1018175,60798,61282,91734,75743,289557
1018176,15913,67533,69529,3507,156482
1018177,95587,21971,42118,49888,209564
1018178,59363,60247,100000,26238,245848
1018179,14187,29642,6053,58677,108559
1018180,90985,4420,84782,58526,238713
1018181,85009,62269,89274,41144,277696
1018182,89598,3611,73473,35266,201948
1018183,70262,58079,19682,85806,233829
1018184,76354,40384,5156,59751,181645
1018185,68875,8674,72972,61692,212213
1018186,51716,57678,62473,26441,198308
1018187,21731,61635,88965,17100,189431
1018188,53178,75287,81413,94809,304687
1018189,11875,3757,46837,73817,136286
1018190,88492,66253,83943,95865,334553
1018191,31404,26572,43802,12966,114744
1018192,67683,75128,76867,10800,230478
1018193,82581,5606,84472,49439,222098
1018194,78504,28992,5936,80825,194257
1018195,40138,33432,63197,17745,154512
1018196,71229,26822,81523,92879,272453
1018197,66063,67990,77163,1848,213064
1018198,33468,75990,53493,31764,194715
1018199,59880,51273,91721,40972,243846
1018200,82324,8757,47369,12279,150729
1018201,43345,99431,40796,43020,226592
1018202,27227,84118,27897,88417,227659
1018203,8045,44033,13748,76781,142607
1018204,13578,32577,48827,71249,166231
1018205,68145,12697,20237,91253,192332
1018206,17991,43724,31053,56185,148953
1018207,92464,93341,69827,16152,271784
1018208,36106,82867,5623,33464,158060
1018209,92994,95959,2080,14595,205628
1018210,92469,25983,77935,10516,206903
1018211,98018,74059,9281,44721,226079
1018212,93937,28658,72523,56065,251183
1018213,38982,78177,48909,80765,246833
1018214,79217,68338,43965,8268,199788
1018215,62886,52619,741,67088,183334
1018216,19562,45956,74664,66166,206348
1018217,60361,59560,77628,46999,244548
1018218,90138,81302,17499,85901,274840
1018219,50633,65691,74917,36799,228040
1018220,35232,46583,7659,50667,140141
1018221,51006,84149,6275,33772,175202
1018222,94728,64507,11441,61192,231868
1018223,97059,5075,85750,91709,279593
1018224,14762,59188,43048,7569,124567
1018225,28854,5198,98286,64245,196583
1018226,3752,7810,62381,80977,154920
1018227,67425,56959,97816,85780,307980
1018228,54826,30531,83280,44234,212871
1018229,23534,14396,2033,42606,82569
1018230,91152,33667,60748,8376,193943
1018231,34028,35481,68077,3824,141410
1018232,72852,27531,76117,79279,255779
1018233,33008,68854,98694,81449,282005
1018234,44627,18590,15364,67472,146053
1018235,82727,83039,51062,91142,307970
1018236,32055,70700,18017,70277,191049
1018237,52023,72370,82358,39838,246589
1018238,91876,84249,21320,23615,221060
1018239,54416,14049,58291,89807,216563
1018240,98780,42502,21598,26556,189436
1018241,14826,4619,86935,323,106703
1018242,46654,84179,2004,89245,222082
1018243,73439,16545,83253,33530,206767
1018244,19970,16675,18136,15473,70254
1018245,39458,88383,68478,55695,252014
1018246,74737,28747,27741,59633,190858
1018247,81849,94683,99745,71012,347289
1018248,16808,94949,77591,53906,243254
1018249,17602,1739,12923,94059,126323
1018250,88191,7551,22178,91390,209310
1018251,59752,92554,13698,42858,208862
1018252,11082,40575,53018,62863,167538
1018253,45054,71006,46306,98482,260848
1018254,99424,30650,70462,16767,217303
1018255,63103,78227,91730,89095,322155
1018256,453,85259,23349,17960,127021
1018257,32650,76287,26596,2677,138210
1018258,50601,20900,49344,3257,124102
1018259,27801,15241,47055,61659,151756
1018260,72537,14763,38009,60084,185393
1018261,21378,47698,45291,92640,207007
1018262,68883,46690,53728,40676,209977
1018263,91275,19525,74829,1828,187457
1018264,26621,54294,14705,85153,180773
1018265,43162,26787,28936,37275,136160
1018266,42617,10441,6029,96859,155946
1018267,98805,68850,71661,3912,243228
1018268,61749,51174,84755,24020,221698
1018269,53295,90222,31220,20868,195605
1018270,33162,90812,60110,96823,280907
1018271,75416,22819,56903,33813,188951
1018272,26986,65056,19989,64919,176950
1018273,5555,4248,94542,50489,154834
1018274,36075,77896,82150,84112,280233
1018275,14555,30914,1959,97095,144523
1018276,44412,31962,56898,68698,201970
1018277,63881,95148,14947,88709,262685
1018278,99376,55009,22582,23096,200063
1018279,72502,63303,3050,64165,203020
1018280,98533,60226,15061,83853,257673
1018281,94077,7193,55365,33259,189894
1018282,1475,38335,58881,42104,140795
1018283,43046,17113,22123,41031,123313
1018284,50908,69644,2005,69285,191842
1018285,82421,74558,95213,63353,315545
1018286,33613,18221,33584,58486,143904
1018287,6961,80847,28002,94787,210597
1018288,27407,26894,56012,61968,172281
1018289,18838,80796,92952,68118,260704
1018290,11622,78129,65056,52253,207060
1018291,14863,42463,64098,24057,145481
1018292,80325,26862,5404,14147,126738
1018293,82518,68135,50547,23759,224959
1018294,55779,56005,7548,93619,212951
1018295,7592,589,13419,945,22545
1018296,71876,68062,12908,57056,209902
1018297,88336,63180,55882,19850,227248
1018298,59622,32109,96211,3830,191772
1018299,37520,65028,85627,37623,225798
1018300,39203,87261,33891,54922,215277
1018301,94321,21254,6521,26528,148624
1018302,3129,94315,98820,55702,251966
1018303,43365,72273,91517,91017,298172
1018304,45131,2043,76088,82974,206236
1018305,29387,7699,86154,48272,171512
1018306,80816,8911,58272,773,148772
1018307,20562,69171,3001,54546,147280
1018308,58174,53018,66714,33266,211172
1018309,40060,90133,1367,72293,203853
1018310,52826,90760,1322,87995,232903
1018311,94702,24089,80593,22057,221441
1018312,88871,14747,60055,35138,198811
1018313,18187,88732,86138,78026,271083
1018314,17107,59026,62397,59426,197956
1018315,59187,30673,83494,58279,231633
1018316,25419,65049,27692,92757,210917
1018317,2232,79458,43915,27831,153436
1018318,69878,66689,20876,56339,213782
1018319,24711,65950,22697,97875,211233
1018320,73014,21179,18927,32660,145780
1018321,64274,47044,8034,88721,208073
1018322,19337,20806,47121,98286,185550
1018323,62825,55449,31317,99579,249170
1018324,57764,82062,16289,34326,190441
1018325,15384,1145,41423,70167,128119
1018326,20829,31274,20078,19459,91640
1018327,74778,2180,78045,83659,238662
1018328,87996,24297,15994,14683,142970
1018329,92138,4776,5336,58175,160425
1018330,11756,88063,32674,38526,171019
1018331,66884,88686,59833,82206,297609
1018332,93004,20421,4853,19910,138188
1018333,91003,76208,72419,63877,303507
1018334,10369,19848,74733,5992,110942
1018335,98513,46763,69966,71290,286532
1018336,39109,17962,76299,68055,201425
1018337,64900,52011,33779,74022,224712
1018338,88317,77231,21020,96634,283202
1018339,93240,69605,21308,96698,280851
1018340,26961,88683,5919,38878,160441
1018341,8426,56576,8661,35532,109195
1018342,64641,46622,73547,95311,280121
1018343,79367,58984,19425,71730,229506
1018344,74275,12254,10637,59044,156210
1018345,18823,28793,96936,62590,207142
1018346,93835,13791,63348,24856,195830
1018347,13928,17282,58324,22666,112200
1018348,54287,36622,68482,51106,210497
1018349,28435,744,39095,13743,82017
1018350,7110,96376,15326,45721,164533
1018351,60555,22344,90867,99663,273429
1018352,81818,5608,63648,69610,220684
1018353,17911,79801,11020,72505,181237
1018354,88357,40207,2271,67536,198371
1018355,12202,76193,44948,43828,177171
1018356,59720,73171,33062,34073,200026
1018357,50087,67175,360,76624,194246
1018358,31450,38702,58169,75448,203769
1018359,3376,79239,88069,89106,259790
1018360,94726,44372,28614,52082,219794
1018361,40928,5467,47235,61105,154735
1018362,39659,4050,37053,95460,176222
1018363,24924,42375,29307,80621,177227
1018364,26142,87708,16537,51270,181657
1018365,60388,61736,59097,65371,246592
1018366,18797,94330,43134,26066,182327
1018367,16027,21156,29952,27824,94959
1018368,85786,23488,59885,65081,234240
1018369,19689,40496,69181,57822,187188
1018370,12502,22980,79612,66512,181606
1018371,68311,48147,44427,63746,224631
1018372,14458,59208,86884,67188,227738
1018373,17706,36451,90481,34115,178753
1018374,23024,54762,37818,59197,174801
1018375,26734,64779,50581,21065,163159
1018376,31091,70634,31182,88842,221749
1018377,77311,88675,87784,70986,324756
1018378,27285,99695,43709,95923,266612
1018379,77088,19782,94899,20071,211840
1018380,97468,92493,87540,14336,291837
1018381,2439,15207,15752,91294,124692
1018382,59611,5593,88351,77459,231014
1018383,96752,52477,13161,47860,210250
1018384,52204,19604,49012,5011,125831
1018385,19223,3816,55306,32779,111124
1018386,87082,68630,70474,65150,291336
1018387,129,28046,64200,81401,173776
1018388,49869,56495,63124,19499,188987
1018389,79970,43374,61923,22632,207899
1018390,75811,84943,72941,24987,258682
1018391,89743,40258,79232,24465,233698
1018392,23307,23243,33056,99622,179228
1018393,50175,88950,20201,45002,204328
1018394,30003,7812,38066,74373,150254
1018395,42535,21300,27812,61061,152708
1018396,12413,17695,44353,42327,116788
1018397,47250,10078,60750,48559,166637
1018398,49416,66965,32743,80603,229727
1018399,61012,60897,75824,70015,267748
1018400,46341,86924,87557,58524,279346
1018401,25862,13498,63072,25296,127728
1018402,14147,67057,94188,97304,272696
1018403,39504,36009,73809,5865,155187
1018404,82716,75891,13185,65531,237323
1018405,26953,67465,40696,31778,166892
1018406,92558,95847,49313,92231,329949
1018407,57386,44897,75227,28249,205759
1018408,16785,4313,64233,47714,133045
1018409,97843,74727,27560,64789,264919
1018410,93143,13455,38385,39156,184139
1018411,26078,61612,86660,37612,211962
1018412,84665,48146,28622,25957,187390
1018413,94545,77398,63481,34095,269519
1018414,43956,40868,47719,13009,145552
1018415,85963,67869,31657,35803,221292
1018416,96991,78293,12720,40230,228234
1018417,80055,27174,19734,90443,217406
1018418,51335,58830,56142,18619,184926
1018419,86720,12699,54620,6177,160216
1018420,13937,42199,34795,40099,131030
1018421,50235,13758,56119,79417,199529
1018422,70666,51430,15225,41875,179196
1018423,99280,90866,1308,83440,274894
1018424,67627,60588,43753,47376,219344
1018425,99638,82150,89085,62036,332909
1018426,32442,70543,79359,33965,216309
1018427,65077,90811,74142,172,230202
1018428,19341,47869,76050,30500,173760
1018429,73643,43539,91734,1490,210406
1018430,44270,64718,79215,80448,268651
1018431,66096,71911,42035,88689,268731
1018432,23757,94828,5941,41269,165795
1018433,35803,41914,19694,9211,106622
1018434,10763,26663,56482,55914,149822
1018435,56920,71423,1928,74399,204670
1018436,39525,15360,81263,32230,168378
1018437,92077,36800,77190,30464,236531
1018438,3460,28565,85280,55870,173175
1018439,11874,85259,86185,98800,282118
1018440,77035,33771,34389,50391,195586
1018441,58135,54264,37868,60729,210996
1018442,13345,81202,60190,36099,190836
1018443,83917,74599,52945,19896,231357
1018444,54310,87086,71935,78806,292137
1018445,36468,50703,85472,15756,188399
1018446,10239,92128,89357,24610,216334
1018447,61235,90203,79,39886,191403
1018448,65272,36802,93683,14470,210227
1018449,31516,39700,41254,7904,120374
1018450,83029,90267,41830,35463,250589
1018451,87559,89327,81006,35034,292926
1018452,50320,17929,57412,39492,165153
1018453,9579,85913,28847,3226,127565
1018454,97847,37230,90474,32132,257683
1018455,90027,51009,64110,21954,227100
1018456,63506,14929,68225,64599,211259
1018457,25230,60336,40207,23161,148934
1018458,52854,31389,65178,81422,230843
1018459,29170,5151,70708,25208,130237
1018460,81441,3349,95064,52045,231899
1018461,13613,22806,84551,36356,157326
1018462,25527,62498,99090,35583,222698
1018463,82276,16735,47682,76074,222767
1018464,63533,25743,94196,96750,280222
1018465,97849,97789,56437,29503,281578
1018466,44626,82601,28533,19620,175380
1018467,16207,14851,98263,30105,159426
1018468,31115,11976,22178,68580,133849
1018469,39780,9675,51499,47208,148162
1018470,45862,34262,2361,71340,153825
1018471,89016,18713,97026,1825,206580
1018472,49339,669,187,80425,130620
1018473,37202,22722,65397,99156,224477
1018474,72773,32823,48654,24240,178490
1018475,73438,40928,52124,77454,243944
1018476,66065,98427,22331,43274,230097
1018477,32389,82995,95335,94715,305434
1018478,30923,9844,94266,77584,212617
1018479,6398,38291,76240,75630,196559
1018480,66974,8509,88955,95253,259691
1018481,81125,69103,8658,91430,250316
1018482,34511,74118,83151,71206,262986
1018483,95229,38938,26002,69160,229329
1018484,26428,74732,66438,37670,205268
1018485,46922,30829,70180,37367,185298
1018486,56402,49358,22694,37139,165593
1018487,75090,45521,43584,64503,228698
1018488,30084,37887,730,3685,72386
1018489,40901,64222,70093,98868,274084
1018490,60618,30032,50992,43210,184852
1018491,42406,63238,85,49579,155308
1018492,52174,40090,76523,12947,181734
1018493,90731,72959,31473,83369,278532
1018494,3762,3087,60740,278,67867
1018495,16582,10272,6523,93021,126398
1018496,32634,97509,14855,80358,225356
1018497,10936,70225,57619,37820,176600
1018498,28352,52516,24928,3673,109469
1018499,84619,6890,35550,57132,184191
1018500,56168,65583,53729,55331,230811
1018501,10920,64401,2228,29942,107491
1018502,46059,93689,58146,18456,216350
1018503,6109,9259,32496,84627,132491
1018504,10394,56463,39090,77691,183638
1018505,92402,87995,72582,2474,255453
1018506,26609,97395,2422,61493,187919
1018507,72307,65042,49284,75215,261848
1018508,94591,85196,61533,65550,306870
1018509,61670,37022,20745,27628,147065
1018510,19116,31892,3348,64611,118967
1018511,28656,73301,22140,52334,176431
1018512,97720,49704,78376,7579,233379
1018513,31441,67432,91140,84106,274119
1018514,7339,3921,66055,3404,80719
1018515,38356,4546,78423,88383,209708
1018516,92904,24110,21845,25698,164557
1018517,5361,1649,7832,93587,108429
1018518,83826,86700,8853,18143,197522
1018519,47836,15242,99599,25231,187908
1018520,31530,48453,83597,40569,204149
1018521,91029,45120,78896,89283,304328
1018522,29743,5620,42099,7354,84816
1018523,91153,87134,23652,93024,294963
1018524,61227,29180,33230,93389,217026
1018525,60425,43276,91423,82457,277581
1018526,16085,18361,70580,62260,167286
1018527,13199,89760,54604,17798,175361
1018528,35826,41729,20536,35613,133704
1018529,28734,76041,40308,21789,166872
1018530,32359,36923,46186,89859,205327
1018531,4027,90089,98016,48102,240234
1018532,57968,607,54228,58647,171450
1018533,390,19747,22321,76974,119432
1018534,53421,74393,99620,73380,300814
1018535,2069,22484,9817,50716,85086
1018536,17388,13142,76732,15654,122916
1018537,86636,12048,78062,62667,239413
1018538,88335,22369,48830,53925,213459
1018539,43241,68147,56315,68359,236062
1018540,44134,17597,23543,53365,138639
1018541,6501,70757,96429,79837,253524
1018542,36061,84621,83374,31255,235311
1018543,57867,34338,3434,91438,187077
1018544,56330,455,70817,34937,162539
1018545,55731,41915,30026,56865,184537
1018546,7085,4228,65244,85213,161770
1018547,94243,67683,50785,4799,217510
1018548,41573,51268,47735,87752,228328
1018549,61667,90362,57130,57669,266828
1018550,34148,92145,93689,11271,231253
1018551,61882,45780,34245,25575,167482
1018552,49674,58970,29078,66226,203948
1018553,66139,59639,96846,20074,242698
1018554,27636,91443,59406,5342,183827
1018555,47381,19012,4259,51955,122607
1018556,30787,13732,2034,5001,51554
1018557,82340,48940,63854,92929,288063
1018558,14639,38654,26507,89429,169229
1018559,8205,37500,12014,63265,120984
1018560,81587,79406,94826,50842,306661
1018561,84901,63585,78609,28542,255637
1018562,94347,16611,66348,27646,204952
1018563,65429,68503,64008,47380,245320
1018564,62506,2868,12658,31599,109631
1018565,7238,74754,30946,95837,208775
1018566,66199,40355,99374,87945,293873
1018567,41852,67204,70480,40329,219865
1018568,97639,67470,22342,39658,227109
1018569,70343,17466,73035,8581,169425
1018570,10815,82563,13885,65903,173166
1018571,3833,48002,92014,75252,219101
1018572,74071,23384,60757,27212,185424
1018573,9016,55377,21627,9548,95568
1018574,73644,95841,7192,21165,197842
1018575,83244,61097,1904,76426,222671
1018576,5534,4353,83518,19874,113279
1018577,35901,86026,13593,54616,190136
1018578,58788,87685,97395,45942,289810
1018579,57170,86711,81418,72054,297353
1018580,69892,95653,35081,8340,208966
1018581,76938,62977,69711,33502,243128
1018582,72220,74021,32367,8628,187236
1018583,81566,19260,55813,38837,195476
1018584,34758,38311,26620,10347,110036
1018585,82992,93427,24069,64285,264773
1018586,65066,90546,71708,85925,313245
1018587,77236,12007,96945,62666,248854
1018588,59439,46476,88591,8395,202901
1018589,50116,99135,44071,89023,282345
1018590,90717,27630,33263,18957,170567
1018591,88886,81616,58305,37434,266241
1018592,94436,2244,73199,39316,209195
1018593,15982,71889,56320,19205,163396
1018594,12180,88681,66150,62587,229598
1018595,72546,79070,26589,22574,200779
1018596,51653,29569,63602,88054,232878
1018597,37304,17487,5924,92597,153312
1018598,12731,11712,23516,10349,58308
1018599,19368,69851,10079,68288,167586
1018600,66627,45069,12920,73289,197905
1018601,75002,31657,19791,25521,151971
1018602,91585,61792,69769,37429,260575
1018603,42456,48358,99165,49162,239141
1018604,19350,35931,58951,18696,132928
1018605,32149,11291,44789,26969,115198
1018606,20358,53894,3858,23962,102072
1018607,48603,81111,30644,14883,175241
1018608,52315,57466,28050,69424,207255
1018609,43963,99039,68297,70264,281563
1018610,55832,54808,30484,48546,189670
1018611,35752,74403,38027,3206,151388
1018612,50631,25749,83749,60846,220975
1018613,91734,23387,83456,90543,289120
1018614,38990,84745,26320,67047,217102
1018615,18414,89805,11743,99494,219456
1018616,62203,14218,15069,86979,178469
1018617,49069,35870,67463,45346,197748
1018618,87354,25933,69302,69944,252533
1018619,19319,24109,18475,14874,76777
1018620,77885,49437,82508,18805,228635
1018621,59583,13191,76425,26762,175961
1018622,34502,62717,2593,67544,167356
1018623,58528,67270,39962,99992,265752
1018624,24344,25690,65382,87767,203183
1018625,71527,15329,45715,24962,157533
1018626,86213,14625,29661,81839,212338
1018627,5575,70853,53645,95802,225875
1018628,23697,30432,64578,93510,212217
1018629,43678,43810,86327,54678,228493
1018630,8771,64345,71559,2956,147631
1018631,81557,75284,11157,42649,210647
1018632,53424,82883,2488,75860,214655
1018633,38291,84285,29530,7244,159350
1018634,10359,99150,43602,90669,243780
1018635,28344,69685,24852,1313,124194
1018636,21858,47121,70052,54686,193717
1018637,95097,27098,50516,18364,191075
1018638,19736,65639,92406,95084,272865
1018639,47103,74037,95425,3731,220296
1018640,51059,9376,16127,39712,116274
1018641,6759,93062,91457,78027,269305
1018642,24395,54699,10177,83841,173112
1018643,54074,43921,95163,26172,219330
1018644,1640,15377,21436,29752,68205
1018645,14900,85900,86271,49522,236593
1018646,32303,99191,33326,89908,254728
1018647,88861,13219,61878,1799,165757
1018648,90636,2664,63779,3501,160580
1018649,58476,85452,16557,1622,162107
1018650,57666,3176,71498,19443,151783
1018651,46685,97624,61224,92367,297900
1018652,16747,24437,75261,40981,157426
1018653,97712,84587,42555,44026,268880
1018654,97912,85410,5771,97808,286901
1018655,24482,75143,10121,87807,197553
1018656,81287,61523,71368,44420,258598
1018657,10739,27288,56315,15903,110245
1018658,11116,49836,61446,7394,129792
1018659,37032,65555,22813,68225,193625
1018660,51775,66405,67913,55559,241652
1018661,57244,44854,95894,87524,285516
1018662,39156,23240,45294,90666,198356
1018663,64470,80684,74248,99575,318977
1018664,45222,17989,7827,55945,126983
1018665,14957,76436,97377,34754,223524
1018666,67992,23402,68158,92825,252377
1018667,50976,61442,68238,63209,243865
1018668,62821,49638,76324,8773,197556
1018669,53354,65325,41988,60397,221064
1018670,37186,11040,38161,57096,143483
1018671,65384,2632,97872,18657,184545
1018672,29204,26146,3110,96996,155456
1018673,16117,98677,87251,81068,283113
1018674,50712,25275,22085,95565,193637
1018675,83332,68408,1735,32641,186116
1018676,78539,22511,91687,99487,292224
1018677,40596,16323,25051,23372,105342
1018678,7648,49187,32415,49151,138401
1018679,98968,33542,7932,1494,141936
1018680,25542,51949,69710,51011,198212
1018681,90537,16251,61591,62179,230558
1018682,36444,74659,96650,99038,306791
1018683,71838,55143,43928,89527,260436
1018684,6775,93381,9354,87171,196681
1018685,18630,90146,6250,68530,183556
1018686,85082,36364,21,15142,136609
1018687,57232,86133,61825,77112,282302
1018688,58375,55754,31205,54165,199499
1018689,88734,51693,71169,97184,308780
1018690,78819,23057,2514,32043,136433
1018691,97284,32809,69234,93355,292682
1018692,56240,68098,12717,17532,154587
1018693,87053,54968,41696,97565,281282
1018694,80010,90217,89012,95852,355091
1018695,83130,4017,33630,82941,203718
1018696,72827,76313,28601,80743,258484
1018697,26574,74788,48069,70118,219549
1018698,3785,80180,33973,2992,120930
1018699,22761,58372,71562,86583,239278
1018700,90468,89647,94931,7856,282902
1018701,86271,26171,98335,70859,281636
1018702,32068,22726,49688,79091,183573
1018703,16899,65709,54842,79179,216629
1018704,21225,87608,23007,2907,134747
1018705,44600,34838,69152,11940,160530
1018706,55891,74628,78174,13734,222427
1018707,12873,98309,13197,1080,125459
1018708,24878,40955,10495,17176,93504
1018709,98740,82393,98969,51058,331160
1018710,72393,91181,32669,1072,197315
1018711,48439,36187,47094,42299,174019
1018712,60130,37310,13962,50218,161620
1018713,4911,94124,28864,40320,168219
1018714,73034,39112,65251,65165,242562
1018715,36244,29773,18031,84235,168283
1018716,5889,59159,33867,16079,114994
1018717,93699,67656,59007,60928,281290
1018718,36350,9691,5144,52262,103447
1018719,83608,83913,28731,21074,217326
1018720,70917,34986,70890,70373,247166
1018721,89793,29315,43843,4103,167054
1018722,48644,36010,38462,19567,142683
1018723,50523,94992,46429,18369,210313
1018724,87735,70945,44003,63359,266042
1018725,57254,57215,79098,38902,232469
1018726,27794,45873,88642,32848,195157
1018727,42511,18944,42162,15574,119191
1018728,3754,92795,82238,83097,261884
1018729,57389,47782,33331,74220,212722
1018730,98338,35018,33428,87999,254783
1018731,83951,95241,7778,34296,221266
1018732,68411,51571,68579,90744,279305
1018733,99869,71772,26199,34044,231884
1018734,88309,70614,1116,57882,217921
1018735,78706,72184,27498,54013,232401
1018736,8021,85605,61177,8776,163579
1018737,72198,77970,48198,29326,227692
1018738,62009,15352,75450,89073,241884
1018739,14593,70621,23353,32453,141020
1018740,65874,37739,74394,35331,213338
1018741,81694,81374,66149,57428,286645
1018742,49470,61383,42929,63008,216790
1018743,99550,49193,234,46593,195570
1018744,55565,56036,7463,89236,208300
1018745,72383,59285,35464,57202,224334
1018746,10411,50183,92937,736,154267
1018747,88629,27803,44673,91935,253040
1018748,74092,42768,63829,57177,237866
1018749,22711,21343,71142,66844,182040
1018750,72951,99364,9882,37113,219310
1018751,90548,40465,12529,60681,204223
1018752,38357,43397,14196,94907,190857
1018753,5956,5355,92079,49927,153317
1018754,29728,23767,81322,30016,164833
1018755,39695,42732,31303,8827,122557
1018756,94324,33687,5508,1207,134726
1018757,38087,38067,78780,57160,212094
1018758,53726,44575,66971,69337,234609
1018759,33880,54043,59305,23424,170652
1018760,33605,40523,23492,96843,194463
1018761,11326,40163,89360,10434,151283
1018762,7685,66566,95742,27474,197467
1018763,96146,54655,81132,63894,295827
1018764,70387,95233,8854,43059,217533
1018765,47327,46737,97716,12608,204388
1018766,14818,54491,70021,35274,174604
1018767,24660,11017,93023,38142,166842
1018768,31369,94223,27991,98960,252543
1018769,31116,59913,29462,95549,216040
1018770,23228,84494,87389,79461,274572
1018771,95008,10386,92916,47032,245342
1018772,34940,47165,92189,76910,251204
1018773,35982,40613,3616,65480,145691
1018774,298,58839,97733,77611,234481
1018775,24695,63084,62941,40405,191125
1018776,68845,82653,14535,80236,246269
1018777,7831,75419,30245,20218,133713
1018778,91637,7618,16084,61364,176703
1018779,42825,51606,64562,73900,232893
1018780,86295,3410,9141,16369,115215
1018781,24671,14191,98506,19780,157148
1018782,57336,18170,54261,15071,144838
1018783,89560,92511,22996,42148,247215
1018784,63294,92108,8933,53851,218186
1018785,34001,44239,77595,38278,194113
1018786,57023,5936,45516,11326,119801
1018787,1229,19464,71879,29830,122402
1018788,22716,4581,20000,45436,92733
1018789,34520,20969,25458,27486,108433
1018790,67542,62621,73375,7356,210894
1018791,71281,69391,64733,20992,226397
1018792,13143,46069,33358,44327,136897
1018793,83709,71418,15348,60805,231280
1018794,73502,95381,92663,25958,287504
1018795,30565,18157,91156,77370,217248
1018796,60908,80160,99106,50277,290451
1018797,14448,76028,37931,36517,164924
1018798,41291,62949,98852,40163,243255
1018799,68642,77671,72060,2611,220984
1018800,74483,49521,74782,92027,290813
1018801,83774,42062,45606,93353,264795
1018802,69927,22373,85818,78355,256473
1018803,33294,41780,39186,49599,163859
1018804,34228,107,66014,87250,187599
1018805,64746,64193,92234,49910,271083
1018806,99198,88380,68041,40710,296329
1018807,59879,96451,22603,97462,276395
1018808,69963,53531,99377,85206,308077
1018809,12808,70322,54604,93918,231652
1018810,17874,43404,1677,70739,133694
1018811,32843,75043,2922,6635,117443
1018812,53484,96117,15808,55307,220716
1018813,51017,68978,96808,52090,268893
1018814,97822,4428,78147,38281,218678
1018815,2038,14319,28733,40204,85294
1018816,45248,4006,28472,25872,103598
1018817,11558,46959,97020,36025,191562
1018818,7956,88914,65620,68040,230530
1018819,13820,39912,60764,38522,153018
1018820,36989,45629,94890,12394,189902
1018821,30962,31051,99422,97835,259270
1018822,10541,66626,1661,15728,94556
1018823,10447,65829,10276,18601,105153
1018824,13016,92764,61455,30832,198067
1018825,83827,24623,34423,72279,215152
1018826,54384,27204,3468,62677,147733
1018827,71066,90477,71781,13352,246676
1018828,43330,38871,62354,20516,165071
1018829,47529,76057,12359,2912,138857
1018830,32839,97332,89343,84788,304302
1018831,30319,3609,62721,30784,127433
1018832,43882,54240,42689,40616,181427
1018833,42951,80743,15988,69027,208709
1018834,68304,15644,32041,95731,211720
1018835,29830,67975,32982,18934,149721
1018836,86084,41294,97496,57448,282322
1018837,42494,14445,74025,36710,167674
1018838,69371,14479,73205,393,157448
1018839,84371,36925,44002,13815,179113
1018840,74763,20758,48901,561,144983
1018841,6341,98602,9262,79214,193419
1018842,84686,99404,15089,19102,218281
1018843,22910,82831,93948,67280,266969
1018844,37105,13466,72492,87843,210906
1018845,5681,6367,84686,37314,134048
1018846,18892,87372,73022,43490,222776
1018847,22381,41325,7310,49586,120602
1018848,48026,30864,6735,88351,173976
1018849,79400,11627,90834,73278,255139
1018850,63801,18700,48194,77976,208671
1018851,76441,93379,22999,39322,232141
1018852,1279,97904,96674,77563,273420
1018853,80596,80254,29813,59099,249762
1018854,71955,20458,81641,82110,256164
1018855,73143,88189,2907,12124,176363
1018856,77765,52314,70894,3548,204521
1018857,62127,33909,76287,3459,175782
1018858,63745,46511,47418,88115,245789
1018859,89389,89739,30214,10392,219734
1018860,49676,8316,56422,30285,144699
1018861,76398,5247,49257,7850,138752
1018862,61352,23766,18768,26938,130824
1018863,96939,33979,55814,66180,252912
1018864,20387,81273,23054,39149,163863
1018865,4154,10988,45459,32871,93472
1018866,85375,21487,5856,77667,190385
1018867,66585,14899,3824,72195,157503
1018868,72785,15919,62959,27881,179544
1018869,89051,71312,62011,4447,226821
1018870,97101,31655,82058,47501,258315
1018871,20220,20805,97485,78775,217285
1018872,41511,84685,21764,28483,176443
1018873,67805,9665,39427,5137,122034
1018874,12210,19809,13942,7401,53362
1018875,78667,20086,50816,3048,152617
1018876,97638,3858,99223,83202,283921
1018877,71645,46117,11996,42488,172246
1018878,71334,64768,39940,15181,191223
1018879,12848,16945,50830,36317,116940
1018880,25765,64152,33794,40153,163864
1018881,16309,84290,36751,3078,140428
1018882,58536,85856,5038,2133,151563
1018883,63037,45994,71277,91068,271376
1018884,29178,93718,92787,3291,218974
1018885,86671,74481,10990,59616,231758
1018886,17809,14266,35818,46091,113984
1018887,70699,28269,54944,92528,246440
1018888,56841,67412,4398,12535,141186
1018889,49116,6273,3566,28258,87213
1018890,41279,3427,91210,23831,159747
1018891,38001,23603,55057,68511,185172
1018892,13782,39491,50040,66419,169732
1018893,81126,4470,68319,47849,201764
1018894,24686,4231,36434,38973,104324
1018895,14307,17343,36709,76350,144709
1018896,56522,49234,70287,50726,226769
1018897,46478,32570,50760,34632,164440
1018898,35201,29169,53078,89966,207414
1018899,9261,70469,73487,42927,196144
1018900,20541,35008,99273,76788,231610
1018901,40611,63001,5338,46456,155406
1018902,57731,68572,67657,11088,205048
1018903,19650,55813,53272,43217,171952
1018904,70177,26192,76504,49675,222548
1018905,21775,11730,33923,90021,157449
1018906,67427,42805,57393,29098,196723
1018907,78182,13267,14147,73217,178813
1018908,52476,81629,82366,21541,238012
1018909,42039,92990,55530,47140,237699
1018910,29127,60706,87096,22293,199222
1018911,82238,58163,18282,29302,187985
1018912,85136,49385,92682,99005,326208
1018913,67547,12333,41594,33905,155379
1018914,32932,34932,58637,40339,166840
1018915,31054,24733,71734,99246,226767
1018916,62821,85515,36705,91825,276866
1018917,56408,71771,99795,8598,236572
1018918,78406,50899,38558,40348,208211
1018919,36131,28433,70816,99791,235171
1018920,79567,50943,44688,37897,213095
1018921,27347,36979,92068,23620,180014
1018922,39155,52911,13174,78615,183855
1018923,98941,78484,82829,35356,295610
1018924,75077,27239,80736,2721,185773
1018925,87434,13264,13104,98414,212216
1018926,18940,93173,83902,12048,208063
1018927,96290,55039,86476,55323,293128
1018928,93842,94537,71142,98991,358512
1018929,43665,57921,46868,90067,238521
1018930,74808,74681,47497,14192,211178
1018931,62923,15429,8379,85224,171955
1018932,11512,57172,95368,20962,185014
1018933,12115,10176,8511,41585,72387
1018934,59564,33816,2834,84175,180389
1018935,1019,63263,64262,76329,204873
1018936,40719,53225,17725,69075,180744
1018937,97204,4122,31459,23561,156346
1018938,70838,67190,30566,99437,268031
1018939,92214,35070,35393,35481,198158
1018940,4683,19215,28132,82220,134250
1018941,12493,58883,88494,17720,177590
1018942,90887,9103,40948,95788,236726
1018943,17977,52498,96899,45749,213123
1018944,34894,4388,10235,86524,136041
1018945,25551,94709,88185,91790,300235
1018946,82533,86977,32620,16081,218211
1018947,11052,60918,51751,6355,130076
1018948,80045,51877,17460,23489,172871
1018949,56656,27754,25967,84748,195125
1018950,46411,51767,51665,82495,232338
1018951,4861,11758,63373,17442,97434
1018952,48047,17070,86045,82203,233365
1018953,24297,56217,83124,58330,221968
1018954,43549,16514,40202,36722,136987
1018955,96809,89659,95836,7259,289563
1018956,80866,98301,54963,96658,330788
1018957,30396,66874,61780,30495,189545
1018958,57872,43039,4669,99329,204909
1018959,16260,31728,25015,60982,133985
1018960,73323,79597,39237,39859,232016
1018961,32558,4615,68956,69841,175970
1018962,73948,64630,71417,68313,278308
1018963,6591,11176,16461,87585,121813
1018964,38181,69027,41520,56539,205267
1018965,92764,1386,23147,37585,154882
1018966,12184,10889,53024,6469,82566
1018967,74615,4784,69549,461,149409
1018968,48783,66137,15359,69830,200109
1018969,75797,41441,44360,83698,245296
1018970,60705,33240,49724,11185,154854
1018971,99288,87713,23905,29839,240745
1018972,64315,822,94843,44729,204709
1018973,79944,98029,56298,78230,312501
1018974,77700,84421,13443,17071,192635
1018975,64169,48798,22650,66226,201843
1018976,32681,89662,96036,69957,288336
1018977,57654,4753,75928,98390,236725
1018978,15418,62174,92840,26248,196680
1018979,58160,43730,96226,82050,280166
1018980,10786,53854,34778,54901,154319
1018981,846,71549,62701,99929,235025
1018982,82767,88306,79358,32573,283004
1018983,87896,89858,84436,39827,302017
1018984,39078,509,87578,226,127391
1018985,36378,58455,8481,46408,149722
1018986,97979,44035,48137,87344,277495
1018987,66879,98713,73574,22278,261444
1018988,58694,23737,36013,10192,128636
1018989,17245,19237,50289,97291,184062
1018990,88431,71307,10632,85050,255420
1018991,42120,22787,79737,79450,224094
1018992,63958,93627,41500,97068,296153
1018993,74118,66231,608,72116,213073
1018994,78255,22189,99504,16111,216059
1018995,24380,20719,36437,61174,142710
1018996,24120,85372,61518,50300,221310
1018997,9145,86283,87951,10954,194333
1018998,63517,56839,3967,65222,189545
1018999,44636,14897,88082,47281,194896
1019000,29039,32327,180,90045,151591
1019001,96847,95786,8618,50375,251626
1019002,34489,26344,7199,17080,85112
1019003,12990,10719,59300,19086,102095
1019004,69686,59910,37151,7247,173994
1019005,76566,14281,28682,39992,159521
1019006,84146,27809,35786,34255,181996
1019007,58979,88313,99167,28557,275016
1019008,61118,73553,49098,46461,230230
1019009,52262,57492,14490,77764,202008
1019010,85820,63749,73944,23369,246882
1019011,85200,71171,16653,97488,270512
1019012,1755,10333,20517,56712,89317
1019013,94024,31626,2101,87943,215694
1019014,25729,42157,90737,19675,178298
1019015,93698,1575,88467,21877,205617
1019016,77904,19199,79890,67821,244814
1019017,75132,93117,95487,14705,278441
1019018,49432,49194,60706,56524,215856
1019019,2518,40210,48210,57898,148836
1019020,61560,70312,49213,19689,200774
1019021,85387,72883,39709,19560,217539
1019022,53992,31567,46674,64602,196835
1019023,34588,60241,53392,25604,173825
1019024,77228,15186,1424,9745,103583
1019025,48071,51938,43773,46486,190268
1019026,92462,80625,4404,1067,178558
1019027,88172,78017,33952,63199,263340
1019028,30396,66871,97761,70211,265239
1019029,87165,40001,30578,30663,188407
1019030,78111,43345,66289,76495,264240
1019031,67057,68377,90899,43115,269448
1019032,28334,53288,81792,73608,237022
1019033,84371,22982,34175,20778,162306
1019034,64362,57571,73336,64496,259765
1019035,43037,31271,57710,41832,173850
1019036,29909,83969,19422,23179,156479
1019037,1473,4668,83444,9579,99164
1019038,65132,42193,58459,31888,197672
1019039,96696,59457,50820,43044,250017
1019040,71064,7730,70445,2279,151518
1019041,36346,93170,97785,62637,289938
1019042,53944,23898,18599,63959,160400
1019043,62918,56323,94999,96145,310385
1019044,78642,12358,15246,71775,178021
1019045,98697,11560,75234,3455,188946
1019046,80470,44410,92232,60249,277361
1019047,87759,73771,57393,47671,266594
1019048,79309,69965,84801,32122,266197
1019049,47587,2554,46858,41362,138361
1019050,48120,90894,12107,13856,164977
1019051,53802,45328,706,43338,143174
1019052,31082,26190,33956,18262,109490
1019053,73407,7221,51308,9928,141864
1019054,85583,13096,1986,50423,151088
1019055,34978,10663,5736,67748,119125
1019056,5381,63587,40127,29995,139090
1019057,95832,39785,71644,51934,259195
1019058,35524,68504,96560,12348,212936
1019059,31265,80807,79451,64656,256179
1019060,83114,98759,58766,71641,312280
1019061,2412,98261,95189,95508,291370
1019062,63501,692,44767,52156,161116
1019063,57654,2319,15172,80831,155976
1019064,26571,52145,73644,10728,163088
1019065,95896,52045,17370,49682,214993
1019066,97674,59011,10349,56851,223885
1019067,71638,71636,69590,30805,243669
1019068,22492,67833,84354,44060,218739
1019069,48884,86630,53489,62878,251881
1019070,88225,64534,76039,86619,315417
1019071,37770,26733,22518,37262,124283
1019072,22924,52729,50398,34629,160680
1019073,27260,48361,6299,64220,146140
1019074,40972,69087,92451,31188,233698
1019075,46730,74094,31641,37121,189586
1019076,94695,89321,65509,23873,273398
1019077,18126,56304,22558,47040,144028
1019078,37382,89160,21119,11397,159058
1019079,26088,77096,62136,40489,205809
1019080,56511,67099,38982,97465,260057
1019081,38561,52184,86883,73466,251094
1019082,44045,75706,10395,40531,170677
1019083,94538,77132,42786,77437,291893
1019084,29302,48308,52380,14055,144045
1019085,14953,45907,57688,40914,159462
1019086,52378,5138,29608,51262,138386
1019087,51352,19738,49060,66024,186174
1019088,84516,27279,9758,67995,189548
1019089,53312,17029,7355,63020,140716
1019090,69810,10517,24090,62022,166439
1019091,63643,70406,39370,53523,226942
1019092,58353,17397,63041,61954,200745
1019093,86302,58278,17845,36402,198827
1019094,87938,97139,47257,13346,245680
1019095,6236,24750,74177,96613,201776
1019096,12635,27645,96342,28365,164987
1019097,34328,24731,47759,79094,185912
1019098,97898,26448,64333,17879,206558
1019099,46295,48542,77304,92630,264771
1019100,3931,34063,12439,50650,101083
1019101,24100,50395,50816,89354,214665
1019102,70135,98981,31677,53182,253975
1019103,37886,82633,39983,51042,211544
1019104,34084,78927,28408,5705,147124
1019105,95132,42818,6014,3939,147903
1019106,48230,11411,6682,1199,67522
1019107,16823,75726,20544,22077,135170
1019108,58330,60294,94670,79694,292988
1019109,37665,88163,8185,26137,160150
1019110,61958,79716,50290,11665,203629
1019111,59907,20299,68117,10488,158811
1019112,51646,27009,78482,19015,176152
1019113,96426,50889,75036,22981,245332
1019114,24623,2973,53340,5852,86788
1019115,54624,16222,11925,64130,146901
1019116,43552,14257,44569,99984,202362
1019117,86941,63091,1036,94426,245494
1019118,12368,83017,23040,88152,206577
1019119,62161,99727,52971,63411,278270
1019120,7206,67166,92854,97357,264583
1019121,57194,60689,24505,33957,176345
1019122,99469,68676,86026,20030,274201
1019123,91423,14306,16665,70513,192907
1019124,77383,58575,71839,87801,295598
1019125,34838,97668,25371,8170,166047
1019126,93429,64267,8185,9111,174992
1019127,59014,20798,64612,80350,224774
1019128,91390,2526,61838,17787,173541
1019129,66381,94169,6795,23327,190672
1019130,14881,79349,28940,13215,136385
1019131,82072,2214,71732,46599,202617
1019132,45491,31270,9314,19710,105785
1019133,86578,10007,87534,57861,241980
1019134,80122,46487,95927,21618,244154
1019135,97137,37042,64599,95274,294052
1019136,20388,71748,5610,46985,144731
1019137,8028,64226,79116,79246,230616
1019138,93070,90706,82570,61302,327648
1019139,52782,31643,84439,70100,238964
1019140,93149,91229,53908,75218,313504
1019141,37805,50570,38458,35933,162766
1019142,95066,8201,12922,1853,118042
1019143,34924,30233,42082,82826,190065
1019144,77994,42626,99947,73928,294495
1019145,84303,49856,95989,97907,328055
1019146,49195,39467,62891,12780,164333
1019147,33425,7641,92260,56749,190075
1019148,37639,34920,73991,96018,242568
1019149,85388,67460,47670,96015,296533
1019150,1481,45391,32192,67292,146356
1019151,39989,42297,73847,69646,225779
1019152,67432,18094,27627,72427,185580
1019153,53,99796,35282,86740,221871
1019154,65074,29341,23667,24252,142334
1019155,12177,77344,78060,90106,257687
1019156,52706,46209,29083,59612,187610
1019157,65862,72736,39638,12727,190963
1019158,78984,32462,28829,70850,211125
1019159,7944,46172,76911,81337,212364
1019160,21035,62469,1473,19353,104330
1019161,83553,51029,57898,25149,217629
1019162,3935,54629,47894,43976,150434
1019163,99269,99241,64797,22358,285665
1019164,78077,24783,40751,92522,236133
1019165,41397,51654,46504,92767,232322
1019166,56880,78983,42751,46185,224799
1019167,82453,17778,24015,28391,152637
1019168,77937,4730,54301,40642,177610
1019169,34192,3808,98658,72055,208713
1019170,1729,94961,96099,94224,287013
1019171,38214,12440,53368,65797,169819
1019172,20991,75036,10750,72597,179374
1019173,52050,79717,24651,79583,236001
1019174,86407,3140,2500,27489,119536
1019175,38902,96578,5907,20933,162320
1019176,29892,12646,93817,98473,234828
1019177,77392,78451,28341,72974,257158
1019178,83253,83850,26648,5757,199508
1019179,54933,56716,84012,36116,231777
1019180,74208,55239,48159,34143,211749
1019181,44405,35450,13408,2595,95858
1019182,31501,5836,77606,88381,203324
1019183,96097,49778,18276,85654,249805
1019184,25805,73432,39041,98249,236527
1019185,3886,92406,23762,89427,209481
1019186,80614,50827,61035,87523,279999
1019187,26494,46486,51140,52553,176673
1019188,57542,51684,10171,69287,188684
1019189,58329,84814,50910,16758,210811
1019190,59136,22433,9666,85588,176823
1019191,48473,63424,95394,68721,276012
1019192,24648,11791,11087,91060,138586
1019193,24517,40446,15951,88883,169797
1019194,36770,28340,61264,85813,212187
1019195,65368,72956,81932,5829,226085
1019196,14011,82662,77200,38946,212819
1019197,58114,19953,10461,51599,140127
1019198,34193,87203,80686,9974,212056
1019199,25801,49507,5584,5950,86842
1019200,47384,58351,22353,71483,199571
1019201,17220,44988,21045,10354,93607
1019202,73071,16406,88147,40367,217991
1019203,98923,56672,9916,20804,186315
1019204,20718,67230,41951,14567,144466
1019205,29123,4829,62450,62385,158787
1019206,97070,45102,29706,19398,191276
1019207,11692,81971,95210,5690,194563
1019208,50523,65965,33815,62957,213260
1019209,15452,86640,50944,12021,165057
1019210,78818,78550,78664,62464,298496
1019211,29094,6720,78396,39873,154083
1019212,4081,23390,63533,31566,122570
1019213,18218,68072,69168,71996,227454
1019214,72350,79832,56475,4454,213111
1019215,69005,66102,27863,38558,201528
1019216,36346,4609,63733,15231,119919
1019217,60586,23255,19582,8708,112131
1019218,90338,18791,16747,42476,168352
1019219,74641,603,52745,89483,217472
1019220,85136,5735,89347,15487,195705
1019221,81360,55252,86592,23086,246290
1019222,61754,87397,99731,32636,281518
1019223,61495,86657,80375,70514,299041
1019224,34281,58264,25973,3059,121577
1019225,19948,57902,72610,12514,162974
1019226,59352,29967,41439,41916,172674
1019227,52892,27648,62632,21129,164301
1019228,35938,28017,26307,48100,138362
1019229,32813,75963,25491,23337,157604
1019230,99799,49618,19761,48327,217505
1019231,1856,22754,77603,26377,128590
1019232,23658,58846,25802,5161,113467
1019233,12480,48701,62155,16962,140298
1019234,18631,6608,20697,45715,91651
1019235,27460,16552,68787,42125,154924
1019236,49639,82725,51762,59367,243493
1019237,20784,80137,26958,29611,157490
1019238,95377,54592,96529,33790,280288
1019239,26788,60808,66021,40210,193827
1019240,34147,76317,24005,27126,161595
1019241,27648,39287,48425,50575,165935
1019242,32541,85232,56731,87978,262482
1019243,87254,72581,29126,8250,197211
1019244,30315,55899,11481,28043,125738
1019245,80571,3769,98584,17429,200353
1019246,36460,99142,93037,9409,238048
1019247,96905,14538,80595,87651,279689
1019248,81789,39959,45924,13735,181407
1019249,64703,36696,44554,53889,199842
1019250,86984,35952,15015,20158,158109
1019251,31713,44328,61592,10997,148630
1019252,14641,37180,86189,99741,237751
1019253,91515,34536,81696,14160,221907
1019254,99696,3261,4846,92950,200753
1019255,43060,47921,64944,9045,164970
1019256,99622,65460,49518,15595,230195
1019257,48600,68162,13803,73448,204013
1019258,41610,58473,32961,47496,180540
1019259,77856,46349,17609,71441,213255
1019260,4900,39637,44533,15743,104813
1019261,25009,14963,83755,57819,181546
1019262,4918,9754,86515,12180,113367
1019263,3764,12685,40924,82358,139731
1019264,45008,31383,92245,24036,192672
1019265,41764,18030,477,83653,143924
1019266,94656,71446,17887,97396,281385
1019267,49323,7134,39216,78395,174068
1019268,84671,63966,69976,2236,220849
1019269,29949,37584,94897,19756,182186
1019270,66629,5305,20088,75993,168015
1019271,49681,85804,91503,24417,251405
1019272,15469,77196,36729,11406,140800
1019273,28769,501,19680,80533,129483
1019274,85892,57446,27098,34808,205244
1019275,79956,35684,99757,70242,285639
1019276,18652,40419,8132,21170,88373
1019277,15517,29803,21509,52822,119651
1019278,21441,31008,24470,84666,161585
1019279,80537,49645,51336,86236,267754
1019280,65622,34878,8729,72303,181532
1019281,10304,38225,97403,48120,194052
1019282,95404,52133,59517,55955,263009
1019283,67347,62808,65840,67813,263808
1019284,13775,88043,82506,94051,278375
1019285,20856,57513,19712,32454,130535
1019286,44546,90131,46552,89200,270429
1019287,82873,12735,72195,79534,247337
1019288,71551,93356,45677,86841,297425
1019289,61509,56070,61815,50424,229818
1019290,66957,69559,3731,94918,235165
1019291,49558,95048,95270,73877,313753
1019292,80095,82875,69083,54470,286523
1019293,40061,72607,72555,7669,192892
1019294,69839,87901,55378,3081,216199
1019295,37951,66953,25012,88990,218906
1019296,99016,9128,17648,82188,207980
1019297,56914,189,86826,74255,218184
1019298,7632,56912,53695,59608,177847
1019299,38349,48349,14520,56346,157564
1019300,21829,69405,68848,66516,226598
1019301,91823,18818,35836,80616,227093
1019302,64333,27103,55595,49735,196766
1019303,84251,12099,78843,20852,196045
1019304,73448,98515,76792,6870,255625
1019305,30725,75457,34472,76815,217469
1019306,79825,44813,47451,96413,268502
1019307,69400,28428,84012,96486,278326
1019308,54855,71892,51634,27877,206258
1019309,24709,13493,98766,68894,205862
1019310,92752,33705,82478,87094,296029
1019311,39951,78526,50361,99541,268379
1019312,91012,42121,35235,36705,205073
1019313,25033,38130,80909,67695,211767
1019314,71370,16916,35871,35529,159686
1019315,29392,9105,7457,20912,66866
1019316,51787,47084,19332,2920,121123
1019317,4342,91485,813,48667,145307
1019318,83751,38415,22138,74434,218738
1019319,74733,36100,82018,8640,201491
1019320,88305,97144,89163,1036,275648
1019321,22239,17816,37281,57355,134691
1019322,87879,9206,34560,83327,214972
1019323,7562,69855,16953,62223,156593
1019324,53091,74410,58206,45084,230791
1019325,18927,56970,87909,4722,168528
1019326,42933,41149,75012,14020,173114
1019327,99628,84813,89407,76935,350783
1019328,95536,392,59602,92131,247661
1019329,36617,10964,49693,82381,179655
1019330,55562,63616,57495,46777,223450
1019331,51329,43449,57987,84628,237393
1019332,23587,66700,50858,65137,206282
1019333,9259,44362,57205,13446,124272
1019334,72176,9518,66435,91099,239228
1019335,54853,1363,76297,30950,163463
1019336,83788,2037,25719,33783,145327
1019337,41043,1217,56888,22116,121264
1019338,82215,97597,21024,43063,243899
1019339,89258,1706,41785,63128,195877
1019340,1666,69715,72783,57012,201176
1019341,11445,61522,29829,68198,170994
1019342,18924,77727,61547,91463,249661
1019343,92594,72740,92098,53859,311291
1019344,47820,94815,62427,53257,258319
1019345,43725,1530,7314,83091,135660
1019346,99448,19485,42672,87330,248935
1019347,98017,23232,98778,52764,272791
1019348,56846,90652,20088,65187,232773
1019349,15570,31525,79840,82059,208994
1019350,48680,36935,92667,60736,239018
1019351,41166,23003,98142,13358,175669
1019352,91198,24245,42295,69054,226792
1019353,19016,96265,51135,52410,218826
1019354,66371,93701,89011,73680,322763
1019355,97876,34445,59949,76409,268679
1019356,69279,2204,64146,11572,147201
1019357,18286,66465,80632,15644,181027
1019358,67988,59802,78500,53335,259625
1019359,49474,87689,19744,88533,245440
1019360,9226,79232,99868,68592,256918
1019361,27130,24830,60665,6028,118653
1019362,10614,25138,52086,15705,103543
1019363,83708,12578,96607,22483,215376
1019364,17201,37250,43017,9452,106920
1019365,16475,49675,6714,71397,144261
1019366,50118,93223,57751,87001,288093
1019367,12529,28513,63855,57337,162234
1019368,96388,57164,32946,55206,241704
1019369,7227,38410,86796,80694,213127
1019370,57896,27742,17191,30072,132901
1019371,74564,18016,80987,37543,211110
1019372,59778,28995,44161,99880,232814
1019373,60010,74513,47898,35669,218090
1019374,93719,49836,34950,36872,215377
1019375,58938,96573,78263,67090,300864
1019376,88042,77849,48404,91006,305301
1019377,25141,31114,72999,32067,161321
1019378,63259,56979,49243,54037,223518
1019379,99111,99495,57944,6209,262759
1019380,55843,35985,53744,31269,176841
1019381,25318,74810,8893,90145,199166
1019382,47191,18092,7428,13730,86441
1019383,59473,16742,16220,57720,150155
1019384,43131,68774,79086,92993,283984
1019385,34908,91395,92549,95709,314561
1019386,80981,95454,7738,13199,197372
1019387,63683,50158,46030,77199,237070
1019388,45129,25727,45469,38135,154460
1019389,50392,48947,66867,23270,189476
1019390,60185,82953,62246,53645,259029
1019391,72021,5754,59315,17703,154793
1019392,35886,98695,43113,2363,180057
1019393,51834,87102,42786,66200,247922
1019394,91631,80472,5079,37691,214873
1019395,45327,55460,22575,81059,204421
1019396,57218,8265,55338,83127,203948
1019397,16112,43591,79620,66319,205642
1019398,99632,22435,71539,88663,282269
1019399,57147,76939,86020,53231,273337
1019400,20602,3079,8417,35051,67149
1019401,13112,80525,62542,85363,241542
1019402,83287,72837,46647,98700,301471
1019403,49193,4423,74289,8051,135956
1019404,78798,79776,29954,80180,268708
1019405,1066,65127,3150,75019,144362
1019406,39300,58466,72782,91710,262258
1019407,29199,34822,80235,72839,217095
1019408,18894,62654,24777,71824,178149
1019409,5717,24413,52944,85040,168114
1019410,61641,68232,15201,19052,164126
1019411,81620,99831,64708,23356,269515
1019412,65662,53924,61757,49685,231028
1019413,1603,18678,85739,36994,143014
1019414,96659,69129,94672,84035,344495
1019415,7928,39525,6916,45094,99463
1019416,1645,76863,73672,75111,227291
1019417,46788,13948,16836,7820,85392
1019418,59742,37980,81018,72426,251166
1019419,48582,14844,70493,82663,216582
1019420,75714,99315,88831,3472,267332
1019421,8752,33824,39548,97472,179596
1019422,99417,76274,12828,65175,253694
1019423,72036,8862,51537,4323,136758
1019424,89812,65315,46054,36263,237444
1019425,61172,30279,66989,95549,253989
1019426,87615,46280,1191,31338,166424
1019427,57334,15551,8533,44727,126145
1019428,36905,15962,57737,51858,162462
1019429,30087,76734,39152,85789,231762
1019430,17066,62109,27131,14675,120981
1019431,26528,99333,4707,16602,147170
1019432,4248,8960,55571,52293,121072
1019433,12621,80468,16915,29558,139562
1019434,59418,7371,63420,98307,228516
1019435,9299,53658,28473,54619,146049
1019436,30899,92498,10279,15549,149225
1019437,17278,90014,86199,27587,221078
1019438,3389,70958,90539,164,165050
1019439,69213,74784,42388,47596,233981
1019440,7920,39963,1664,54309,103856
1019441,50141,38671,59082,73961,221855
1019442,51887,744,32470,49943,135044
1019443,79102,98561,21081,60115,258859
1019444,73849,19321,81668,15170,190008
1019445,28999,80830,39081,26454,175364
1019446,2737,2905,15428,54725,75795
1019447,25515,77641,82040,75972,261168
1019448,60786,27278,54667,81736,224467
1019449,46393,18214,98560,78630,241797
1019450,41293,45770,99921,23863,210847
1019451,78979,21150,54060,74795,228984
1019452,46619,52265,22010,6597,127491
1019453,18544,4000,64082,727,87353
1019454,99630,10070,27236,65612,202548
1019455,3200,67652,20867,49034,140753
1019456,33675,29457,38329,3216,104677
1019457,32078,43282,91797,98721,265878
1019458,91590,61846,75194,22766,251396
1019459,88519,37287,72197,15255,213258
1019460,26598,38419,79312,17952,162281
1019461,31848,10879,97050,11996,151773
1019462,30237,80951,826,42463,154477
1019463,12920,42522,2216,56886,114544
1019464,43481,62580,64505,36917,207483
1019465,83675,1925,94120,86581,266301
1019466,85768,53932,60118,63354,263172
1019467,84701,72532,4455,85870,247558
1019468,51706,67541,93154,53697,266098
1019469,33862,12135,86284,58392,190673
1019470,31137,41420,74080,42380,189017
1019471,8473,1356,32282,59559,101670
1019472,83615,8148,53130,57158,202051
1019473,43389,78000,50827,1620,173836
1019474,24768,569,54499,75167,155003
1019475,8510,67370,14854,34663,125397
1019476,68048,6404,41170,3537,119159
1019477,36893,78739,10759,45478,171869
1019478,81170,54938,49765,60699,246572
1019479,60434,24759,84392,65631,235216
1019480,82000,13656,17719,21467,134842
1019481,77852,74267,19754,99681,271554
1019482,7464,69873,56655,5116,139108
1019483,67428,3120,92138,59979,222665
1019484,83331,99930,8345,42273,233879
1019485,67449,53750,67286,67631,256116
1019486,2787,65837,48348,99412,216384
1019487,62416,44748,851,85241,193256
1019488,58719,11082,10714,60264,140779
1019489,11333,44987,32887,46667,135874
1019490,10881,99054,87221,56631,253787
1019491,48576,61855,22466,81318,214215
1019492,77508,91465,14639,32041,215653
1019493,35143,77772,90129,54337,257381
1019494,19727,14121,37226,51061,122135
1019495,7085,90829,80484,31808,210206
1019496,33794,8023,69001,59054,169872
1019497,81532,31878,98410,29678,241498
1019498,54939,58016,94409,78484,285848
1019499,47976,46897,74317,54975,224165
1019500,32825,49307,40090,32767,154989
1019501,17938,14741,77209,17438,127326
1019502,75242,65306,85887,25306,251741
1019503,92511,10438,45111,1972,150032
1019504,28049,40327,29895,90323,188594
1019505,71122,42468,30658,37326,181574
1019506,41593,21641,40933,25357,129524
1019507,95869,54466,9880,67040,227255
1019508,71674,16976,15615,86209,190474
1019509,1261,69346,46530,71395,188532
1019510,7216,50494,76267,7011,140988
1019511,50573,59797,88495,63547,262412
1019512,26010,80693,24710,76683,208096
1019513,74660,57046,11082,31065,173853
1019514,94225,84262,62709,74779,315975
1019515,92523,99294,54774,43494,290085
1019516,11095,22444,43999,80395,157933
1019517,89208,74878,12689,66604,243379
1019518,61407,7674,57490,13086,139657
1019519,68629,11031,96156,79513,255329
1019520,95601,20744,76753,13743,206841
1019521,20191,92290,11576,32463,156520
1019522,63812,75341,95676,42971,277800
1019523,8243,79805,60193,26998,175239
1019524,4858,52825,793,67110,125586
1019525,28305,69221,74672,55618,227816
1019526,33052,61013,69809,46576,210450
1019527,15394,16415,15491,96606,143906
1019528,7355,95808,935,93281,197379
1019529,99950,3088,38836,42678,184552
1019530,71735,19743,59041,36212,186731
1019531,27113,93417,36625,87132,244287
1019532,2597,18063,72952,86353,179965
1019533,77009,44152,37203,27491,185855
1019534,47833,60445,62507,66152,236937
1019535,52656,68540,66566,55568,243330
1019536,63569,48388,67295,52256,231508
1019537,12143,2652,33533,16769,65097
1019538,50520,98824,54091,91802,295237
1019539,13756,33068,85640,77655,210119
1019540,57069,20377,83777,53261,214484
1019541,46567,82540,60785,2027,191919
1019542,42674,33064,31228,50538,157504
1019543,72002,43010,18412,77020,210444
1019544,59410,16889,82945,95044,254288
1019545,52013,24349,61486,31342,169190
1019546,25098,99369,49663,47941,222071
1019547,12314,34782,32576,84154,163826
1019548,55702,88666,17734,19165,181267
1019549,60252,3201,20773,33171,117397
1019550,59451,69242,58839,45943,233475
1019551,78210,52220,34873,47747,213050
1019552,21908,16292,58394,2274,98868
1019553,61541,21601,30485,25069,138696
1019554,16979,90822,53181,84399,245381
1019555,77344,7638,81978,30304,197264
1019556,99525,63071,49765,79068,291429
1019557,16880,62073,16102,93179,188234
1019558,56071,93182,40525,52129,241907
1019559,78681,98904,42040,80485,300110
1019560,11267,80859,57508,76245,225879
1019561,65525,63070,95471,86048,310114
1019562,27465,78404,60123,41352,207344
1019563,74805,44392,40977,6027,166201
1019564,42022,36335,14363,93609,186329
1019565,97493,34561,45349,40410,217813
1019566,76137,70819,684,5874,153514
1019567,38363,53666,43320,88151,223500
1019568,68254,47549,96369,11445,223617
1019569,10444,69608,83115,86454,249621
1019570,23100,2912,34080,97889,157981
1019571,18860,60638,91794,48772,220064
1019572,7228,95702,58896,84031,245857
1019573,98844,65361,90126,1596,255927
1019574,60891,93043,57864,43905,255703
1019575,58719,37694,14427,34878,145718
1019576,68675,29369,99226,78938,276208
1019577,63626,84579,20042,9438,177685
1019578,38531,79690,80829,85205,284255
1019579,26237,73872,90683,97353,288145
1019580,43329,60683,52029,76124,232165
1019581,66220,24420,52353,85630,228623
1019582,1744,33272,66053,83227,184296
1019583,92061,54800,96047,23792,266700
1019584,62168,16064,6657,5635,90524
1019585,84700,95667,16077,42887,239331
1019586,5536,33621,21181,48320,108658
1019587,62831,78921,50339,29567,221658
1019588,57282,64396,50669,67509,239856
1019589,57874,36553,82704,45668,222799
1019590,21075,30557,26931,64601,143164
1019591,38080,16630,88166,38291,181167
1019592,43194,19389,29870,99660,192113
1019593,62440,33671,24965,15644,136720
1019594,23687,6641,13949,32909,77186
1019595,12939,73866,64282,4957,156044
1019596,39432,26636,24220,56029,146317
1019597,58621,76374,51569,71289,257853
1019598,81812,92707,36505,4566,215590
1019599,71882,67617,18547,61277,219323
1019600,47176,9308,99847,55848,212179
1019601,83179,5435,57789,21193,167596
1019602,28468,80273,21527,36453,166721
1019603,7587,16852,22853,63686,110978
1019604,17822,72947,71171,30428,192368
1019605,26130,33136,1326,13566,74158
1019606,36379,7265,53016,15009,111669
1019607,58138,50684,60027,85040,253889
1019608,28982,63216,53332,27667,173197
1019609,61430,38623,67801,30101,197955
1019610,56125,45864,22492,78392,202873
1019611,9440,68579,13987,18895,110901
1019612,24963,35759,1139,93498,155359
1019613,95828,97735,79856,64511,337930
1019614,9448,72661,93062,42625,217796
1019615,96037,3028,44566,47802,191433
1019616,26874,26071,95775,28122,176842
1019617,920,52479,94752,22347,170498
1019618,52432,56851,76989,713,186985
1019619,2846,61377,41033,99057,204313
1019620,35122,70914,20409,88962,215407
1019621,20163,90858,73027,11110,195158
1019622,19562,95719,31152,71420,217853
1019623,79108,97301,7953,45415,229777
1019624,70964,54366,28385,68620,222335
1019625,88683,73076,10759,41919,214437
1019626,18711,93149,8017,33013,152890
1019627,57474,90971,18002,98498,264945
1019628,205,27479,71458,62826,161968
1019629,35678,12627,39019,61999,149323
1019630,65104,60411,28728,97114,251357
1019631,19138,89090,81338,56118,245684
1019632,4581,40167,30173,34631,109552
1019633,63924,53583,74944,41040,233491
1019634,76990,88357,43620,44827,253794
1019635,90430,56481,66632,52743,266286
1019636,9030,90598,42897,66848,209373
1019637,96411,7989,67234,83855,255489
1019638,27434,75674,25671,11413,140192
1019639,22003,76744,71710,55215,225672
1019640,93719,94488,58064,55427,301698
1019641,9719,84518,87308,64657,246202
1019642,86870,22688,81626,51648,242832
1019643,14308,34997,21527,90128,160960
1019644,78074,8174,30542,87433,204223
1019645,38885,2208,21216,58731,121040
1019646,35549,20140,63594,34818,154101
1019647,37898,21206,85863,76093,221060
1019648,25797,95766,78923,83008,283494
1019649,5238,31533,28544,31375,96690
1019650,80849,9788,24061,63821,178519
1019651,63394,97829,25315,65172,251710
1019652,24338,80062,12748,2428,119576
1019653,56672,90289,16282,72786,236029
1019654,20028,4428,71332,76177,171965
1019655,53603,82447,93342,12379,241771
1019656,61748,92942,66832,28933,250455
1019657,43108,62816,65591,7205,178720
1019658,47431,71700,11394,68031,198556
1019659,16683,57638,32615,26874,133810
1019660,36094,62866,55802,60856,215618
1019661,81551,99743,86111,14819,282224
1019662,50459,26406,75086,55102,207053
1019663,75646,4612,19504,41774,141536
1019664,3776,68381,1622,95400,169179
1019665,42480,53272,7605,28163,131520
1019666,18027,65287,96256,10151,189721
1019667,82394,24204,18548,86746,211892
1019668,81866,86382,59374,26448,254070
1019669,5601,32886,48124,35850,122461
1019670,60173,67186,25495,4726,157580
1019671,1223,18709,56180,38918,115030
1019672,30103,14176,16168,73271,133718
1019673,60010,52911,21543,76378,210842
1019674,50359,17852,68646,58717,195574
1019675,65718,25489,44133,81844,217184
1019676,98829,54692,57334,93849,304704
1019677,10344,19340,47692,82539,159915
1019678,33649,67839,65836,75613,242937
1019679,47650,1743,28186,78626,156205
1019680,16972,83490,50933,82401,233796
1019681,94232,27164,98456,82256,302108
1019682,71610,79052,10127,58964,219753
1019683,52841,58194,3162,99333,213530
1019684,50858,54504,6155,5970,117487
1019685,11320,26772,8461,28022,74575
1019686,81717,63405,40910,53059,239091
1019687,61805,61771,13741,27884,165201
1019688,64783,88082,67146,84692,304703
1019689,47739,1317,34108,21273,104437
1019690,8064,29977,51141,20821,110003
1019691,48874,51905,30563,51676,183018
1019692,58743,12197,8930,91712,171582
1019693,37965,27384,99183,61870,226402
1019694,74363,88419,54154,18309,235245
1019695,8388,11291,86851,73209,179739
1019696,80285,48025,94174,29815,252299
1019697,12958,97948,59298,25910,196114
1019698,15923,87009,78578,76376,257886
1019699,15183,5820,11449,6196,38648
1019700,48081,43076,90834,98227,280218
1019701,89579,62129,22847,92991,267546
1019702,33729,94051,13370,78223,219373
1019703,47248,16409,37205,26385,127247
1019704,94494,9271,61160,84528,249453
1019705,93582,89202,93143,92902,368829
1019706,80699,86401,61080,99906,328086
1019707,21316,72655,16928,56193,167092
1019708,69431,42345,57020,5758,174554
1019709,47903,66647,81023,46586,242159
1019710,84349,66075,34617,16719,201760
1019711,73691,11661,53275,71437,210064
1019712,42638,824,42696,55995,142153
1019713,48537,22103,2381,66510,139531
1019714,11821,83479,97045,14615,206960
1019715,35821,39350,91817,77738,244726
1019716,72906,73130,88466,30936,265438
1019717,3475,16330,30120,61792,111717
1019718,20371,38898,27153,7923,94345
1019719,87608,99641,53017,5490,245756
1019720,48522,94382,42623,29239,214766
1019721,20738,95583,7951,32030,156302
1019722,21641,19042,80512,52005,173200
1019723,27995,89029,47651,64030,228705
1019724,48156,94825,33855,32193,209029
1019725,88909,46802,51723,63286,250720
1019726,56189,67481,5378,85322,214370
1019727,74699,47321,37013,33331,192364
1019728,89440,84365,95633,7529,276967
1019729,95255,35837,86,63072,194250
1019730,62247,73118,79393,76254,291012
1019731,85104,4363,45366,45347,180180
1019732,51988,5557,93251,31941,182737
1019733,7611,25282,95572,754,129219
1019734,59227,83709,81581,4015,228532
1019735,45742,44048,962,19699,110451
1019736,12954,68025,77721,69373,228073
1019737,73106,894,60604,67903,202507
1019738,90772,32077,18777,21005,162631
1019739,14049,61058,82986,35893,193986
1019740,75629,81682,77783,96296,331390
1019741,19410,96837,55802,68808,240857
1019742,84741,58443,94310,86512,324006
1019743,59553,78780,66582,25480,230395
1019744,88151,9177,68300,19533,185161
1019745,14579,32140,94936,24909,166564
1019746,15114,54044,83276,55115,207549
1019747,19613,11964,52489,92509,176575
1019748,13063,45970,38838,62166,160037
1019749,2787,1797,44404,2331,51319
1019750,25121,19412,76591,28791,149915
1019751,43301,56328,684,9693,110006
1019752,72452,40554,77869,58399,249274
1019753,37444,77028,25143,17081,156696
1019754,45837,56413,1066,11228,114544
1019755,87319,32531,15805,60140,195795
1019756,33279,97516,25975,75997,232767
1019757,46901,19907,49123,87518,203449
1019758,6624,37352,43237,66011,153224
1019759,98122,18199,84345,11442,212108
1019760,40658,42577,19416,29352,132003
1019761,54532,79857,72454,5395,212238
1019762,74271,97934,59711,88038,319954
1019763,18312,16720,4171,7239,46442
1019764,87077,65465,77101,44422,274065
1019765,62778,29565,14228,58444,165015
1019766,27461,98751,85841,26241,238294
1019767,8054,79454,65199,73368,226075
1019768,65937,82261,76598,88922,313718
1019769,13547,32379,4090,91096,141112
1019770,20511,92718,64605,41719,219553
1019771,50774,4164,41141,51506,147585
1019772,2909,89045,87127,92879,271960
1019773,62858,35002,83983,9565,191408
1019774,18663,65770,20279,24465,129177
1019775,34344,46549,90128,98085,269106
1019776,58380,44271,55459,33989,192099
1019777,81578,43854,13116,28237,166785
1019778,36158,41995,55298,53986,187437
1019779,91303,60960,79611,21894,253768
1019780,54051,31943,28688,60745,175427
1019781,91180,1239,37770,61225,191414
1019782,29863,23771,22326,65566,141526
1019783,71568,1774,40712,70965,185019
1019784,71639,50731,31851,44531,198752
1019785,27263,4433,28771,74251,134718
1019786,69839,88259,51087,56937,266122
1019787,44547,75997,8821,64103,193468
1019788,48519,94556,22211,40922,206208
1019789,26096,57126,89180,12371,184773
1019790,63371,82658,32458,16846,195333
1019791,60191,13839,11718,92940,178688
1019792,31270,77744,14859,89507,213380
1019793,959,2815,33521,8924,46219
1019794,2662,85201,13592,50131,151586
1019795,30663,56442,874,98141,186120
1019796,39821,62243,34650,92759,229473
1019797,62543,1716,65092,24052,153403
1019798,2544,89470,44199,77828,214041
1019799,75095,51739,67353,81286,275473
1019800,5318,2658,60365,19859,88200
1019801,34842,287,40799,66199,142127
1019802,49223,44662,58985,4731,157601
1019803,76463,75112,45676,33319,230570
1019804,94096,51089,77066,48089,270340
1019805,79422,94359,36611,83481,293873
1019806,87214,4627,31047,99803,222691
1019807,48036,93176,81379,41567,264158
1019808,83509,80707,31568,91179,286963
1019809,66916,18548,1522,71582,158568
1019810,13691,58820,53746,78152,204409
1019811,91197,65761,33301,81895,272154
1019812,86409,53849,77652,83206,301116
1019813,34707,26514,11295,55555,128071
1019814,31442,33251,55151,40559,160403
1019815,7087,67167,21888,66116,162258
1019816,31227,607,56299,84196,172329
1019817,31693,88411,31034,85700,236838
1019818,82854,19223,7824,85237,195138
1019819,43571,98219,8527,677,150994
1019820,43661,12434,57802,3360,117257
1019821,58984,60062,26869,97239,243154
1019822,83860,37653,13282,77202,211997
1019823,94256,74150,62783,22568,253757
1019824,42164,12359,31307,74932,160762
1019825,86533,28169,34730,45622,195054
1019826,69893,46183,94733,73555,284364
1019827,20397,42522,14853,71058,148830
1019828,54438,81496,9174,15654,160762
1019829,38801,97304,5974,82414,224493
1019830,69712,64558,39270,64912,238452
1019831,26937,57752,43871,14109,142669
1019832,32808,99842,69445,31255,233350
1019833,72941,71302,45436,14210,203889
1019834,61568,77367,80758,16484,236177
1019835,7476,15446,58638,15126,96686
1019836,83316,8538,94943,75579,262376
1019837,96517,56176,94803,41101,288597
1019838,62395,24769,60811,90076,238051
1019839,11183,15355,37470,22008,86016
1019840,50100,2107,82599,79110,213916
1019841,99685,27687,95030,14924,237326
1019842,46993,58136,16426,49213,170768
1019843,97526,6184,15015,69338,188063
1019844,39503,20451,73024,64866,197844
1019845,52568,37172,33891,69281,192912
1019846,33499,51236,26163,52167,163065
1019847,46119,66432,45718,87893,246162
1019848,50324,1060,25801,41634,118819
1019849,54801,55359,20366,28111,158637
1019850,56317,13239,80952,37277,187785
1019851,49769,70652,91854,27364,239639
1019852,37208,86486,19172,19501,162367
1019853,68334,52694,39062,89005,249095
1019854,85531,10812,33140,71650,201133
1019855,66532,41752,90478,29569,228331
1019856,57796,62443,87461,25805,233505
1019857,99108,14403,44835,60541,218887
1019858,91539,13277,69039,1905,175760
1019859,39209,86780,88527,7338,221854
1019860,17435,45198,36192,23555,122380
1019861,4782,72347,34011,39194,150334
1019862,77373,62687,26428,82322,248810
1019863,74480,55520,5348,11566,146914
1019864,42322,37206,79682,38530,197740
1019865,55960,56059,76595,35159,223773
1019866,10074,83901,3456,66671,164102
1019867,39766,13329,81535,59,134689
1019868,14422,48054,42961,50524,155961
1019869,30706,27981,429,92775,151891
1019870,58262,77001,85472,75755,296490
1019871,42259,43885,82256,65569,233969
1019872,46567,89018,84866,69425,289876
1019873,76043,79922,17231,37273,210469
1019874,24874,4487,8203,19381,56945
1019875,7107,46084,7921,59652,120764
1019876,68908,43575,1864,98560,212907
1019877,58327,20808,38024,58099,175258
1019878,19284,73747,29094,13442,135567
1019879,11176,7703,37188,82387,138454
1019880,37979,67687,51004,68664,225334
1019881,50051,79296,49560,55228,234135
1019882,90608,33651,49662,52107,226028
1019883,66789,81468,18745,16116,183118
1019884,52150,22378,57232,75067,206827
1019885,8726,96693,98562,61365,265346
1019886,88002,48338,38490,36025,210855
1019887,78556,44354,36041,87763,246714
1019888,39043,77314,41862,93162,251381
1019889,41635,80849,5344,39476,167304
1019890,42126,11058,54409,77625,185218
1019891,30014,30201,65798,28049,154062
1019892,38854,5823,40105,79340,164122
1019893,66152,36465,86647,12458,201722
1019894,29193,44479,47566,15792,137030
1019895,15579,75037,43268,3522,137406
1019896,31767,34191,98823,89821,254602
1019897,7143,68823,7705,33141,116812
1019898,10672,5147,73448,42837,132104
1019899,78769,83913,19963,64083,246728
1019900,97326,53198,5686,31100,187310
1019901,1408,36480,80345,37935,156168
1019902,21386,92147,5619,40865,160017
1019903,18363,52415,44215,97491,212484
1019904,96674,45261,18945,7,160887
1019905,26001,36328,78615,19648,160592
1019906,26783,45883,22011,84044,178721
1019907,62078,48665,21459,42501,174703
1019908,5296,19246,98064,8843,131449
1019909,92921,59627,38279,31309,222136
1019910,71816,99619,4385,39839,215659
1019911,89215,8342,91717,78181,267455
1019912,40676,70243,16054,23802,150775
1019913,9760,5967,73827,99172,188726
1019914,90580,59438,47349,8362,205729
1019915,60988,96576,33374,99307,290245
1019916,30323,31619,4873,51463,118278
1019917,30308,2633,73170,10647,116758
1019918,39220,40629,95297,27269,202415
1019919,3371,67101,24899,32797,128168
1019920,6179,14846,50331,12278,83634
1019921,51503,67640,18494,47094,184731
1019922,65610,69154,92298,75259,302321
1019923,51911,12277,4041,22323,90552
1019924,16723,25425,19947,99311,161406
1019925,43868,51370,44042,99302,238582
1019926,46811,83273,96927,48408,275419
1019927,72386,51056,8469,14554,146465
1019928,1580,34007,6196,40345,82128
1019929,42173,28905,82561,43415,197054
1019930,91115,18076,16,32646,141853
1019931,64171,610,18592,9326,92699
1019932,94617,88494,81127,94835,359073
1019933,89620,78192,92284,40205,300301
1019934,91754,27633,42450,63217,225054
1019935,94784,84072,7442,47398,233696
1019936,78024,97802,60488,36797,273111
1019937,30137,1439,74527,31474,137577
1019938,26366,72986,9925,70052,179329
1019939,70233,745,19321,95660,185959
1019940,82154,35421,68358,87976,273909
1019941,44906,40522,99962,60179,245569
1019942,24721,90773,89974,22796,228264
1019943,77577,6855,31546,76379,192357
1019944,73167,4954,37522,57264,172907
1019945,24793,43381,72886,95486,236546
1019946,17237,75472,64206,88235,245150
1019947,87667,7045,41609,1424,137745
1019948,37053,61777,97662,54037,250529
1019949,67164,18763,34276,40458,160661
1019950,98035,35762,97778,77804,309379
1019951,88935,29790,16851,77407,212983
1019952,90750,97427,19332,24492,232001
1019953,2029,89590,53784,80792,226195
1019954,48549,29950,37489,58026,174014
1019955,56510,40713,82549,49366,229138
1019956,53924,76215,7732,87225,225096
1019957,22793,96471,85421,59120,263805
1019958,86770,77105,98666,30252,292793
1019959,69204,242,78956,33382,181784
1019960,1355,82424,79987,88431,252197
1019961,5397,30099,65482,51429,152407
1019962,70698,22384,4033,768,97883
1019963,26246,5344,63676,99172,194438
1019964,72555,59900,75709,99533,307697
1019965,32869,51065,32159,86503,202596
1019966,34448,58243,78126,33836,204653
1019967,53998,49612,7490,60430,171530
1019968,63176,66399,51539,88713,269827
1019969,56617,34469,28375,86884,206345
1019970,81887,18348,35984,49101,185320
1019971,75733,47351,73819,97170,294073
1019972,30290,29407,59601,59904,179202
1019973,27941,14453,46741,18736,107871
1019974,47493,12117,79311,5302,144223
1019975,12898,4632,26015,13944,57489
1019976,95394,96870,26499,98774,317537
1019977,97516,41160,33486,24398,196560
1019978,15956,91704,40795,90558,239013
1019979,4999,47846,63777,51612,168234
1019980,68384,608,87086,77506,233584
1019981,2632,92937,81516,45138,222223
1019982,34127,8580,79323,72959,194989
1019983,34880,99585,40358,96371,271194
1019984,23551,66175,88783,43965,222474
1019985,32039,62334,10342,48913,153628
1019986,45804,295,65323,45649,157071
1019987,482,88961,33746,64610,187799
1019988,39545,66136,99069,66352,271102
1019989,60316,55677,53484,70011,239488
1019990,83836,85564,52376,23801,245577
1019991,13383,71206,99069,64153,247811
1019992,16993,9396,12700,43870,82959
1019993,84027,32175,29837,31639,177678
1019994,26238,23614,76156,2364,128372
1019995,1715,81342,80550,35057,198664
1019996,71335,52816,94042,17430,235623
1019997,26868,54813,24965,49923,156569
1019998,92798,23932,36060,4349,157139
1019999,27055,13675,41618,74041,156389
1020000,11084,27481,29864,79670,148099